 #####  #####
 #   ####   #
## #$. .$ # #
#   $.@.$   #
# # $. .$# ##
#   ####   #
#####  #####