#############
#.         .#
# ##  #  ## #
#  ## $ ### #
#  ##$$$##  #
#   $...$   #
#.#$$.#.$$#.#
#   $...$   #
#.###$@$###.#
#   $...$   #
#.#$$.#.$$#.#
#   $...$   #
#  ##$$$##  #
# ### $ ##  #
# ##  #  ## #
#.         .#
#############