          ####
          #  #
          #  #
          #  #
############ #
##   $ $ $ $$#
# @  $.. . . #
#   #   .  .$#
#####$.   .  #
    #  .   .$#
    #$.  .   #####
    # . . ..$#   #
    #$$ $ $ $    #
    # ############
    #  #
    #  #
    #  #
    ####