   #### ####
  ##  ###  #####
###    #   #   #
# $ $.$ $.$ $  #
#  . . . . .  ##
## .$ $.$ $. ##
 ##  # @#   ##
  ####  #####
     ####