   #####
   ##  #  ####
 ###   ####  #
 #  . $ #    ###
 #   .$ #   . ##
 ##   # ## .   #
  #  ## ###$$  #
  #####@     ###
###      #####
#  $$### ##  #
#   . ## #   ##
## .   # $.   #
###    # $ .  #
  #  ####   ###
  ####  #  ##
        #####