  ########
 ## .   @#
## .$.$. #
#  $.$  ##
# $.$  ##
####   #
   #   #
   #####