        ########
        ###  ###
     ####     ##
######   . $ . #
###   . $  #   #
## . $  #####$ ##
#    ####   # . #
#  $##   #  #   #
##   #  # # ##$ ###
## . # #   # # . ##
### $## # #  #   ##
  #   #  #   ##$  #
  # . #   ####    #
  ## $#####  $ . ##
   #   #  $ .   ###
   # . $ .   ######
   ##     ####
   ###@ ###
   ########