############################
#                          #
# $ $ $ $ $ $ $ $ $ $ $ $  #
# $ $ $ $ $ $ $ $ $ $ $ $  #
# $ $ $ $ $ $ $ $ $ $ $ $  #
# $ $ $ $ $ $ $ $ $ $ $ $  #
# $ $ $ $ $ $ $ $ $ $ $ $  #
# $ $ $ $ $ $ $ $ $ $ $ $  #
# $ $ $ $ $ $ $ $ $ $ $ $  #
# $ $ $ $ $ $ $ $ $ $ $ $  #
# $ $ $ $ $ $ $ $ $ $ $ $