  #####
  #   #
  # # ####
### # #  #
#   # #  #
# # # #  #
# # # ####
# # #  #
# # #  #
# # #  #
# # #  #
# # #  #
# # #  #
# # #  #
# # #  ####
# # #    . #
# # #   .. #
# # #  . ..#
# # # .    #
# # # .    #
# # # .    #
# # # .    #
# # # .    #
# # # .    #
# # # .    #
# # # .    #
# # # .    #
# # # .    #
# # # .    #
# # # .    #
# # # .    #
###@#######