      #####
     ##   #
    ##  $ #
   ##  $  #
  ##  $  ##
  #  $  ##
  # $  ##
  #  $ #
  # $ #
###  # ####
#    . .  #
#   . .   #
#  . .    #
# .@.     #
#  . .    #
#   . .   #
#    . .  #
#### #  ###
   #  $  #
   ## $  #
    # $  #
    #   ##
    #####