###################################
#  .  .  .  .  .  .  .  .  .  .  .  #
# # # # # # # # # # # # # # # # # # #
# $ $ $ $ $ $ $ $ $ $ $ $ $ $ $ $ $ #
# $ $ $ $ $ $ $ $ $ $ $ $ $ $ $ $ $ #
# $ $ $ $ $ $ $ $ $ $ $ $ $ $ $ $ $ #
# $ $ $ $ $ $ $ $ $ $ $ $ $ $ $ $ $ #
# $ $ $ $ $ $ $ $ $ $ $ $ $ $ $ $ $ #
# $ $ $ $