      #####
      #   #
      # # ####
      # # #  #
      # # $$.#
    #####$. ##
    #  $$.#  #
    # @ # #  #
    #   # #####
    #####