            ####
            #  #
            #  #
            #  #
         #####  #####
         #        . #
         #  ####    #
##########  #  ## $ #
#.........  #  #  $ #
#.........  #  # $  #
#.........  #  # $  #
#.........  #  # $  #
#.........  #  # $  #
#.........  #  # $  #
#.........  #  # $  #
##########  #  ## $ #
         #  #    ####
         #  #  $ #
         #  #  $ #
         #  #  $ #
         #####  #####
            #  #
            #  #
            #  #
            #  #
            ####