        ####
       ##  ####
       # $ $ ##
       #  . . #
       ##. .  #
 ####### . # ##
 #  $ $ $ $  #
 # # # # # # #####
## # # # # # #   #
#  # # # # # # . #
# $ # # # # # . ##
# @ # # # # # .#
# $ # # # # # ##
#  # # # # #  #
## # # # # # ##
 #  # # # #  #
 # ## # # ## #
 #   # # # $  #
 ##### # # # ##
       # # # #
       #  $  #
       ## $ ##
        #  ##
        ####