################################
#                              #
# $ $ $ $ $ $ $ $ $ $ $ $ $ $  #
# $ $ $ $ $ $ $ $ $ $ $ $ $ $  #
# $ $ $ $ $ $ $ $ $ $ $ $ $ $  #
# $ $ $ $ $ $ $ $ $ $ $ $ $ $  #
# $ $ $ $ $ $ $ $ $ $ $ $ $ $  #
# $ $ $ $ $ $ $ $ $ $ $ $ $ $  #
# $ $ $ $ $ $ $ $ $ $ $ $ $ $  #
# $ $ $ $ $ $ $ $ $