#############################
#  #  #  #  #  #  #  #  #  #  #
# $ $ $ $ $ $ $ $ $ $ $ $ $ $ #
# $ $ $ $ $ $ $ $ $ $ $ $ $ $ #
# $ $ $ $ $ $ $ $ $ $ $ $ $ $ #
# $ $ $ $ $ $ $ $ $ $ $ $ $ $ #
# $ $ $ $ $ $ $ $ $ $ $ $ $ $ #
# $ $ $ $ $ $ $ $ $ $ $ $ $ $ #
# $ $ $ $ $ $ $ $ $ $ $ $ $ $ #
# $ $ $ $ $ $ $ $ $