        ####
  #######  #
  # $ $ $  #
  # . .$. ##
  ### # .$.#
    #    .@#
    ########