############################
#       #   #   #   #   #  #
# . . . . . . . . . . . .  #
#  $ $ $ $ $ $ $ $ $ $ $ $ #
# . . . . . . . . . . . .  #
#  $ $ $ $ $ $ $ $ $ $ $ $ #
# . . . . . . . . . . . .  #
#  $ $ $ $ $ $ $ $ $ $ $ $ #
#. . . . . . . . . . . . . #
#  $ $ $ $ $ $ $ $ $ $ $ $ #
#. . . . . . . . . . . . .