#################
#               #
# .$.$.$.$.$.$. #
# $.$.$.$.$.$.$ #
# .$.$.$.$.$.$. #
# $.$.$.$.$.$.$ #
# .$.$.$.$.$.$. #
# $.$.$.$.$.$.$ #
# .$.$.$.$.$.$. #
# $.$.$.$.$.$.$ #
# .$.$.$.$.$.$. #
# $.$.$.$.$.$.$ #
# .$.$.$.$.$.$. #
# $.$.$.$.$.$.$ #
# .$.$.$.$.$.$. #
# $.$.$.$ $.$.$ #
# . .$.$.$ $. $ #
# $.$.$.$.$.$.$ #
# . .$.$.$ $. $ #
# $.$.$.$ $.$.$ #
# . .$.$.$ $. $ #
# $.$.$.$.$.$.$ #
#               #
#################