#############
#           #
#  $ $ $ $  ##
# #.#.#.#.#  #
## $ $ $ $ $#
 #.#.#.#.#.# #
 #$ $ $ $ $ #
 #.#.#.#.#.#$#
 # $ $ $ $ $ #
 #$.#.#.#.#.# #
 # $ $ $ $ $  #
 #.###.###.###.#
 # $ $ $ $ $ $ #
 #.###.###.###.#
 # $ $ $ $ $ $ #
 #.###.###.###.#
 # $ $ $ $ $ $ #
 #.###.###.###.#
 # $ $ $ $ $ $ #
 #.###.###.###.#
 # $ $ $ $ $ $ #
 #.###.###.###.#
 # $ $ $ $ $ $ #
 #.###.###.###.#
 # $ $ $ $ $ $ #
 #.###.###.###@#
 #           #
 #############