            #####
            #   #
            # $ ####
            #  $   #
            ## # # ####
           ##  $ $ $  #
           #  #$# #   #
           # $     #  #
           #  $  # # $#
           #  # $# #  #
           #$ $ $ $  ##
           #   # # $##
           ## # #   #
            #   $  ##
            #### # #####
               # $ $ $ #
               #  #    #
               # $ $ $ #
               #    #  #
               #####  @#
                   #####
