################################
#                              #
#  .    .    .    .    .    .  #
#  .$  .$  .$  .$  .$  .$  $.  #
#  .    .    .    .    .    .  #
#  .$  .$  .$  .$  .$  .$  $.  #
#  .    .    .    .    .    .  #
#  .$  .$  .$  .$  .$  .$  $.  #
#  .    .    .    .    .    .  #
#  .$  .$  .$  .$  .$  .$  $.  #
#  .    .    .    .    .    .  #
#  .$  .$  .$  .$  .$  .$  $.  #
#  .    .    .    .    .    .  #
#  .$  .$  .$  .$  .$  .$  $.  #
#  .    .    .    .    .    .  #
#  .$  .$  .$  .$  .$  .$  $.  #
#  .    .    .    .    .    .  #
#  .$  .$  .$  .$  .$  .$  $.  #
#  . @                       # #
################################