                          #####
                          #   #
                          # $ #
                          #   ####
                          ##$#  #
                           # #$ #
                           #  $ #
                           # #  #
                           # #$ #
                           #  $ #
                           # # ##
                 ###########   #
        ########### @         ##
        #         #   #########
        #         #
        #         #
        ###########