        #####
        #   #
######### # ####
#         $    #
# $  $ $ $ $ $ #
### ### ### ###
  #  @    #
  #      #
  #      #
  ########