        ####
  ########  #
  #  $ $ $  #
  # #. . .# #
  # $  $  $ #
  #  . . .# #
  # $ $ $  $#
  # . . .# #     ####
  # $ $ $  #######  #
  # . . .# #   @   ##
  # $ $ $  #   #   #
  # . . .# #   #   #
  # $ $ $  #   #   #
  # . . .# #   #   #
  # $ $ $  #   #   #
  # . . .# #   #   #
  # $ $ $  #   #   #
  # . . .# #   #   #
  # $ $ $  #   #   #
  # . . .# #   #   #
  # $ $ $  #   #   #
  #  . . .# #   #   #
  # $ $ $  #   #   #
  #  $ $ $  #   #   #
  ##########   #####