      ####
     ##  ###
######  $ ###
##  # $    ##
#  $  $ #   #
# # $ #  #  #
#  $ $  #   #
## #$# ## ###
 # $  $  $ #
 #   # $ # ####
 ##    $  $    #
 ##  #   # $  #
  #### #$#  $ #
      #   #   #
      ##  #####
       ####
       #  #
       #  #
       # @#
       ####