         ####
   #######  ####
  ## $ $ $ $ $ #
### #.#.#.#.#.# ##
#  .. .. .. ..  #
# #.#.#.#.#.#.# #
#  .. .. .. ..  #
# #.#.#.#.#.#.# #
#  .. .. .. ..  #
# #.#.#.#.#.#.# #
#  .. .. .. ..  #
# #.#.#.#.#.#.# #
#  .. .. .. ..  #
# #.#.#.#.#.#.# #
#  .. .. .. ..  #
### #.#.#.#.#.# ##
  # $ $ $ $ $ ##
  ####  #######
     ####