 #####
 ##  ####
 #  $$  #
 #  . . #
###$# # #  ####
#  . . .  ##  ##
# $ $ $ $ @  $ #
##### #  ##    #
     #    ######
     ######