       #######
  ######     ######
###    #  $ $ #    ###
#  . . # $ $ $ # .  #
# . .  ### ### ###  #
#  . . . #     #  .  #
# . . .  #  @  # .  #
#  . . . #     #  .  #
# . . .### ### ###  #
#  . . # $ $ $ # .  #
###   # $ $ $ #   ###
  ######     ######
       #######