     ####
     #  #
  #####  #
  #  $ $ ###
  # $  $  #
  ### #####
   #  #
####  ####
#   @   #
#  $.$  #
### # ###
  #   #
  #####