    ####
    #  #
    #  #####
    # . $  #
  ### #$ # #
  #  .  #  #
###  # $   #
#  $  .  # #
# #  $ # ###
#  #  .  #
##### #@ #
    #    #
    ######