       ####
    ####  #
    #  $  #
    #  .  #
  ####.####
  #      #
  # .$$. #
  #  ..  #
### $.$ ###
#   ..   #
# $.$ $.$#
###.   .###
  # $.$ #
  #     #
  #  @  #
  #  #  #
  #######