    #####
    #   #
    #   #
    #   ######
    #      @ #
    #      $ #
  ### ###$ $ #
  #  ...# $ #
###  ...#  #
#  $ # $ # #
# $  #   # #
#   #   #  #
#####  #####
    #####
    #   #####
    # $ #   #
    #  $    #
    # $ # $ #
    #   #  ##
    #  $   #
    ###  ###
      #  #
      ####