############################
# . # . # . # . # . # . # . #
# $ $ $ $ $ $ $ $ $ $ $ $ $ #
#  $.$  $.$  $.$  $.$  $.$  #
# $ $ $ $ $ $ $ $ $ $ $ $ $ #
#  $.$  $.$  $.$  $.$  $.$  #
# $ $ $ $ $ $ $ $ $ $ $ $ $ #
#  $.$  $.$  $.$  $.$  $.$  #
# $ $ $ $ $ $ $ $ $ $ $ $ $ #
#  $.$  $.$  $.$  $.$  $.$  #
# $ $ $ $ $ $ $ $ $ $ $ $ $ #
#  $.$  $.$  $.$  $.$  $.$  #
# $ $ $ $ $ $ $ $ $ $ $ $ $ #
#  $.$  $.$  $.$  $.$  $.$  #
# $ $ $ $ $ $ $ $ $ $ $ $ $ #
#  $.$  $.$  $.$  $.$  $.$  #
# $ $ $ $ $ $ $ $ $ $ $ $ $ #
#  $.$  $.$  $.$  $.$  $.$  #
# $ $ $ $