############################
# .  .  .  .  .  .  .  .  . #
# $ $ $ $ $ $ $ $ $ $ $ $ $ #
###  ######  ######  ####  ##
# $ $ $ $ $ $ $ $ $ $ $ $ $ #
#  ####  ###  ####  ###  #  #
# $ $ $ $ $ $ $ $ $ $ $ $ $ #
#  ###  #  ##  ###  #  ##  #
# $ $ $ $ $ $ $ $ $ $ $ $ $ #
#  ##  # $ $ $ $  ##  #  ## #
# $ $ $ $ $ $ $ $ $ $ $ $ $ #
#  #  # $ $ $ $ $ $  #  #  #
# $ $ $ $ $ $ $ $ $ $ $ $ $ #
#  #  # $ $ $ $ $ $  #  #  #
# $ $ $ $ $ $ $ $ $ $ $ $ $ #
#  ##  # $ $ $