#############################
#  #  #  #  #  #  #  #  #  #  #
# $.$ $.$ $.$ $.$ $.$ $.$ $.$ #
# $.$ $.$ $.$ $.$ $.$ $.$ $.$ #
# $.$ $.$ $.$ $.$ $.$ $.$ $.$ #
# $.$ $.$ $.$ $.$ $.$ $.$ $.$ #
# $.$ $.$ $.$ $.$ $.$ $.$ $.$ #
# $.$ $.$ $.$ $.$ $.$ $.$ $.$ #
# $.$ $.$ $.$ $.$ $.$ $.$ $.$ #
# $.$ $.$ $.$ $.$ $.$ $.$ $.$ #
# $.$ $.$ $.$ $.$ $.$ $.$ $.$ #
# @       $       $       $   #
#############################