     #######
     #  #  #
     #     #
     ## ## #
    ##  .  ##
    #  # #  #
    #   $   #
    ## ## ##
   ##  . .  ##
   #  # # #  #
   #  $ $ $  #
   #  # # #  #
   #  $ $ $  #
   #  # # #  #
   ## . . . ##
    ## # # ##
    #  $@$  #
    ## # # ##
    ## . . ##
     #  #  #
     #  #  #
     #######