############################
#  .  .  .  .  .  .  .  .  #
# $.$.$.$.$.$.$.$.$.$.$.$ #
#  .  .  .  .  .  .  .  .  #
# $.$.$.$.$.$.$.$.$.$.$.$ #
#  .  .  .  .  .  .  .  .  #
# $.$.$.$.$.$.$.$.$.$.$.$ #
#  .  .  .  .  .  .  .  .  #
# $.$.$.$.$.$.$.$.$.$.$.$ #
#  .  .  .  .  .  .  .  .@ #
############################