         ####
  #########  #
  #  $ $ $ $ #
  # #.#.#.#.$#
  # $ $ $ $#@#
  #.###.###$ #
  # $ $ $ $  #
  #.###.###$ #
  # $ $ $ $ ##
  #.###.###$ #  ####
  # $ $ $ $ #  #  #
  #.###.###$.# #  #
  # $ $ $ $ # $ $ #
  #.###.###$ #.###.#
  # $ $ $ $ # $ $ $ #
  #.###.###$.#.#.#.#.#
  # $ $ $ $ # $ $ $ $ #
  #.###.###$ #.###.###.#
  # $ $ $ $ # $ $ $ $  #
  #.###.###$ #.###.###$ #
  # $ $ $ $ # $ $ $ $ $ #
  #.###.###$.#.#.#.#.#.$#
  # $ $ $ $ # $ $ $ $ $ #
  #.###.###$ #.###.###$ #
  # $ $ $ $ # $ $ $ $ $ #
  #.###.###$ #.###.###$ #
  #         #         ###
  ###########