  #####
  #   #####
  #   $ $ #
  #  $.$  #
  ## .$.$##
  #  $.$  #
### .$.$  #
#  $.$ ###
#  $ $ #
# @   #
#######