#####
#   #
# # #####
#     $ #
#  #  $ #
## ####.#
 # # #..#
 #    @.#
 #  # #.#
 #  # # #
 #  $   #
 #  $####
 #  #
 ####