###################################
#  . # # # # # # # # # # # # # #  .  #
# $.$.$.$.$.$.$.$.$.$.$.$.$.$.$.$.$ #
#. . . . . . . . . . . . . . . . . .#
# $.$.$.$.$.$.$.$.$.$.$.$.$.$.$.$.$ #
#  . # # # # # # # # # # # # # #  .  #
# $.$.$.$.$.$.$.$.$.$.$.$.$.$.$.$.$ #
#. . . . . . . . . . . . . .