         ####
         #  #
         #  #
       ###  ###
       #  $$ #
 ## #####  # ######
## #   ###    #   #
#  # $     #  $ $ #
# #  $  #  # #  $ #
#  $  $ #  # #  $ #
# #  $  #  # #  $ #
#  $  $ #  # #  $ #
# #  $  #  # #  $ #
#  $  $ #  # #  $ #
# #  $  #  # #  $ #
#  # $     #  $ $ #
## #   ###    #   #
 ## #####  # ######
       #  $$ #
       ###  ###
         #  #
         #  #
         ####