   #####
   #   #######
   # #$  $ $ #
   # #  .$.$ #
   # #$ $ $  #
   # #  $@$  #
   # #$ $ $  #
   # #  .$.$ #
### $  $ $  ##
#  ####### # #
# #       # # #
# #  #  # # # #
# #  #  # # # #
# #  #  # # # #
# #  #  # # # #
# #  #  # # # #
# #  #  # # # #
# #  #  # # # #
# #  #  # # # #
# #  #  # # # #
# #  #  # # # #
# #  #  # #  ##
# #  #  # #  #
# #  #  # ####
# ########
###