      ####
      #  #
      #  #
      #  #
      #  ####
      ##$.$ ####
     ## . . $ #
     # $.$##  #
     #  #  #  #
  #####  #  # ##
  #   #####   #
  # # $ $ $ # #
  #    $@$    #
  # # $ $ $ # #
  #   #####   #
  ##  #  #  ####
   ## #  # ##
    #  #  #
    #  #  #
    ####  #
       #  #
       #  #
       #  #
 ####  #  #
 #  ####  #
 # $ .$ ##$
 #  . . $##
 # ##$.$ ##
 # ####  #
 #      ##
 #  ####
 ####