############################
# . . . . . . . . . . . .  #
# $ $ $ $ $ $ $ $ $ $ $ $  #
#  $ $ $ $ $ $ $ $ $ $ $   #
# $ $ $ $ $ $ $ $ $ $ $ $  #
#  $ $ $ $ $ $ $ $ $ $ $   #
# $ $ $ $ $ $ $ $ $ $ $ $  #
#  $ $ $ $ $ $ $ $ $ $ $   #
#@ $ $ $ $ $ $ $ $ $ $ $ $ #
############################