   #####
  ##   #####
  #  #     ####
 ## $ $ ##    #
 #  $ $ #  #   #
 # $ $  #  # # #
 #  $ $ #  # # #
 # $ $  #  # # #
 #  $ $ #  # # #
 # $ $  #  # # #
 #  $ $ #  # # #
 # $ $  #  # # #
 #  $ $ #  # # #
 ## $ $ ##    #
  #  #     #  #
  #   @#    $ #
  ######     ##
       ####  #
          ####