############################
#   #  #  #  #  #  #  #  #   #
#   #  #  #  #  #  #  #  #   #
# $ $ $ $ $ $ $ $ $ $ $ $ $ #
# $ $ $ $ $ $ $ $ $ $ $ $ $ #
# $ $ $ $ $ $ $ $ $ $ $ $ $ #
# $ $ $ $ $ $ $ $ $ $ $ $ $ #
# $ $ $ $ $ $ $ $ $ $ $ $ $ #
# $ $ $ $ $ $ $ $ $ $ $ $ $ #
# $ $ $ $ $ $ $ $ $ $ $ $ $ #
# $ $ $ $ $ $ $ $ $ $ $ $ $ #
# $ $ $ $