    #####
    #   #
    # # #####
    #   #   #
##### # # # #
#   #     # #
# $ $ $ $ $ #
## $.$.$.$.$##
 # $ $ $ $ $ #
 # .$.$.$.$. #
 # $ $ $ $ $ #
## $.$.$.$.$##
# $ $ $ $ $ #
# # # # # # #
# $ $ $ $ $ #
# # # # # # #
# $ $ $ $ $ #
# # # # # # #
# $ $ $ $ $ #
### # # # ###
  #       #
  ####@####
    #   #
    #####