############################
#   #   #   #   #   #   #  ##
# . . . . . . . . . . . .  ##
# $.$.$.$.$.$.$.$.$.$.$.$  ##
# $.$.$.$.$.$.$.$.$.$.$.$  ##
# $.$.$.$.$.$.$.$.$.$.$.$  ##
# $.$.$.$.$.$.$.$.$.$.$.$  ##
# $.$.$.$.$.$.$.$.$.$.$.$  ##
# $.$.$.$.$.$.$.$.$.$.$.$  ##
# $.$.$.$.$.$.$.$.$.$.$.$  ##
# $.$.$.$.$.$.$.$.$.$.$.$  ##
# $.$.$.$.$.$.$.$.$.$