    #########
    #       #
    #  # #  #####
    #  $ $  #   #
    #  . .  #   #
    # $.$.$ #   #
    #  . .  #   #
  ### $.$.$ #####  ####
  #   . .  #   ####  #
  #  $.$.$ #   #  #  #
### $.$.$ #   #  #  #
#   . .  #   #  #  #
#  $.$.$ #   #  #  #
#   . .  #   #  #  #
##### $.$.$ ### ####
    #  . .  #
    #   #   #
    #  $ $  #
    #   #   #
    #  $ $  #
    #   #   #
    #  $ $  #
    #   #   #
    #  $ $  #
    #   #   #
    # @ #   #
    #########