            ####
            #  #
            #  #
#########   ##  #  ########
#       #####   ####      #
# $ $ $ $ $ $ $ $ $ $ $ $ #
#.$.$.$.$.$.$.$.$.$.$.$.$.#
# $ $ $ $ $ $ $ $ $ $ $ $ #
#.$.$.$.$.$.$.$.$.$.$.$.$.#
# $ $ $ $ $ $ $ $ $ $ $ $ #
#.$.$.$.$.$.$.$.$.$.$.$.$.#
# $ $ $ $ $ $ $ $ $ $ $ $ #
#.$.$.$.$.$.$.$.$.$.$.$.$.#
# $ $ $ $ $ $ $ $ $ $ $ $ #
#.$.$.$.$.$