    ####
    #  #
    #  ####
    #   $ #
#####  $ #
#   #  $ #
# . . #  #
#  #. . ##
# $ #. . #
##  #. . #
 # $ #.  #
 #  $ #. #
 # $  #  #
 #  $  ####
 # $  @  #
 #  $  ####
 ####  #
    #  #
    #  #
    ####