################################
# $ $ $ $ $ $ $ $ $ $ $ $ $ $ $ #
# .$ .$ .$ .$ .$ .$ .$ .$ .$ .$ #
# $ $ $ $ $ $ $ $ $ $ $ $ $ $ $ #
# .$ .$ .$ .$ .$ .$ .$ .$ .$ .$ #
# $ $ $ $ $ $ $ $ $ $ $ $ $ $ $ #
# .$ .$ .$ .$ .$ .$ .$ .$ .$ .$ #
# $ $ $ $ $ $ $ $ $ $ $ $ $ $ $ #
# .$ .$ .$ .$ .$ .$ .$ .$ .$ .$ #
# $ $ $ $ $ $ $ $