#######
##  #  #
## .$. #
#  $.$ #
#  .$.###
# # $#@##
#     ###
#########