  ######
 ##    #
 #  .$.#
 #  .$.#######
 ## $.$.$.$.$#
 #  .$.#.#.#.#
 # $.$.$.$.$##
 #  .$.#.#.#
 ## $.$.$.$#
 #  .$.#.#.#
 # $.$.$.$##
 #  .$.#.#.#
 ## $.$.$.@#
 #  .$.#  ##
 ######