  ############################
  #   #   #   # #   #   #   #
### # # # # # # # # # # # ###
#   #   #   # #   #   #   #   #
# ##### ##### ##### ##### #####
#   #   #   # #   #   #   #   #
### # # # # # # # # # # # # ###
#   #   #   # #   #   #   #   #
# ##### ##### ##### ##### #####
#   #   #   # #   #   #   #   #
### # # # # # # # # # # # # ###
#   #   #   # #   #   #   #   #
# ##### ##### ##### ##### #####
#   #   #   # #   #   #   #   #
### # # # # # # # # # # # # ###
#   #   #   # #   #   #   #   #
# ##### ##### ##### ##### #####
#   #   #   # #   #   #   #   #
### # # # # # # # # # # # # ###
#   #   #   # #   #   #   #   #
##############################