  #####
###   ###
##  .$.  ##
#  $.$.$  #
# $.$.$.$ #
# $.$.$.$ #
# $.$.$.$ #
# $.$.$.$ #
# $.$.$.$ #
# $.$.$.$ #
# $.$.$.$ #
# $.$.$.$ #
# $.$.$.$ #
# $.$.$.$ #
# $.$.$.$ #
# $.$.$.$ #
# $.$.$.$ #
# $.$.$.$ #
#  $.$.$  #
#   @.@   #
###  #  ###
  #####