####################################
#  .#  #  #  #  #  #  #  #  #  #  .  #
#   .  .  .  .  .  .  .  .  .  .   .#
#  .#  #  #  #  #  #  #  #  #  #  .  #
#   .  .  .  .  .  .  .  .  .  .   .#
#  .#  #  #  #  #  #  #  #  #  #  .  #
#   .  .  .  .  .  .  .  .  .  .   .#
#  .#  #  #  #  #  #  #  #  #  #  .  #
#   .  .  .  .  .  .  .  .  .  .   .#
#  .#  #  #  #  #  #  #  #  #  #  .  #
#   .  .  .  .  .  .  .  .  .  .   .#
#  .#  #  #  #  #  #  #  #  #  #  .  #
#   .  .  .  .  .  .  .  .  .  .   .#
#  .#  #  #  #  #