    #######
    #  #  #
    #     #
    ## ## #
   ##  .  #
   #  #.$ #
 ### #    #
##  .# ## #
# $.$     #
#   #  # ##
# ## ##  ##
# @     #  
#########