     #####
     #   #
     #   ####
     #       ###
     #  $  $   #
     ## # # #  #
    ### $ $ $  #
    #  # # # ##.#
    # $ $ $ $   #
    #  # # # ## #
    #  $     $  #
    #  #####   #
    ####   #@###
       #####