      ####
      #  #
      #  #
      #  #
      #  #
      #  #
      #  #
      #  #
      #  ####
      #     #
      #  $  #
      # .$. #
      ## $ ##
       # @ #
     ### $ ###
     #  $ $  #
     # . . . #
     #  $ $  #
     ### $ ###
       # @ #
       ## ##
       #  #
       #  #
       #  #
       #  #
       #  #
       #  #
      ######