    ####
    #  #####
    #  $ $ #
    ##.$.$.#
   ##  $ $ #
 ###  $ $  #
 #  $ $ $  #
 # $ $ $  ##
 #  $ $  ##
 ###  $ ###
   ##...##
   ## @ ##
   ##...##
   ###  ###
 ####  $  #
 #  $ $ $ #
 # $ $ $  #
 #  $ $ $ #
 #####  # 
     ####