     #####
     #   #
     #   #
     #   ##########
     ######   #   #
       #   $  $ $ #
       #  .#  #   #
       # $.$  $ $ #
       #  .#  #   #
       # $.$  $ $ #
       #  .#  #   #
       # $.$  $ $ #
       #  .#  #   #
       # $.$  $ $ #
       #  .#  #   #
       # $.$  $ $ #
       #  .#  #   #
     ### $.$  $ $ ###
     #   # # #   # #
     #   $.$  $ $  #
     #   # # #   # #
     #   $.$  $ $  #
     #   # # #   # #
     #######@#######
           ###