   #######
  ##     #
  #  # # #
  #  $ $ #
  ## $.$ #
### $.$ ###
#   $.$   #
#  $.$.$  #
# $.$.$.$ #
#  $.$.$  #
# $.$.$.$ #
#  $.$.$  #
# $.$.$.$ #
#   $.$   #
### $.$ ###
  ## $ ##
  #  $  #
  #  #  #
  ## @ ##
  #######