    #####
    #   #####
    # $     ####
    # .$  #   #
    ## ###   ##
   #   $  $$ # #####
   #  $ #   ###    #
   ## # # # #  #   #
  ##  $ $ $ $  #   #
  #  # # # # #  #  #
  #  $ $ $ $  #  ##
  #   #   # $ ##   #
  # #######$ .    #
  ##       $ .#   #
   #   # # # ######
   #  $  $  #
   ##  $ $  #
   #  # # # #
   # $  $  ##
   ### # #  #
     #   $  #
     #    ###
     #####
        #