   ####
  ##  ####
 ##  $   #
 #  # #$.##
 # $  #.#.#
 ## # #...#
 #  $ $...###
 # # ##...@ #
 #     #######
 #######       ####
       ##$##$#     #
       #     #######
       #######     #
             #     #
       #######     #
       #     #######
       #######     #
             #     #
       #######     #
       #     #######
       #######     #
             #     #
       #######     #
       #     #######
       ##$##$#     #
 #######       ####
 #     ####
 #     #
 #######