   #####
  ##   ####
 ##       #
 #   #  # #
 # $  $   #
## # # #  #
#  $ $ $ ##
#  # # # #
####   # #
   ##   ##
   #####
  ##   ####
 ##       #
 #   #  # #
 # $  $   #
## # # #  #
#  $ $ $ ##
#  # # # #
####   # #
   ##   ##
   #####
  ##   ####
 ##       #
 #   #  # #
 # $  $   #
## # # #  #
#  $ $ $ ##
#  # # # #
####   # #
   ##   ##
   #####