      ####
      #  #
      #  #
      #  ###########
      #  #         #
      #  #  $  $   #
      #  # #.$.$.  #
      ######.$.$####
         #  #.#  #
     #####  .$.  ########
     #   # #.$.# #      #
     #  $  $   $  $  $   #
     #   # #.$.# #      #
     #####  .$.  ########
         #  #.#  #
      ######.$.$####
      #  #  $  $  #
      #  # .$. #  #
      #  ###########
      #  #
      #  #
      #  #
      ####