   ####
   #  #
  ##$.#####
  #  $  $ #
  # $.$.$ #
  #  $.$  #
  ## .$.$ #
 ## $.$.$ #
 #  $.$  ##
 # $.$.$  #
 #  .$.$ ##
 ##  $.$ #
  # $.$.$ #
  #  $.$  #
  # $.$.$ #
  #  $.$  #
  ## .$.$ #
  ##$.$.$ #
   #  $  ##
   # $.$ #
   #  @  #
   ######