 #####
##   ##
#  #  #
#  $  #
## # ##
 #   #
## # ##
#  $  #
#  #  #
##   ##
 ##$##
 #   #
## # ##
#  $  #
#  #  #
##   ##
 #####
