###############################
#   #   #   #   #   #   #   #   #
# # # # # # # # # # # # # # # # #
#   #   #   #   #   #   #   #   #
### ### ### ### ### ### ### ### #
#   #   #   #   #   #   #   #   #
# # # # # # # # # # # # # # # # #
#   #   #   #   #   #   #   #   #
### ### ### ### ### ### ### ### #
#   #   #   #   #   #   #   #   #
# # # # # # # # # # # # # # # # #
#   #   #   #   #   #   #   #   #
### ### ### ### ### ### ### ### #
#   #   #   #   #   #   #   #   #
# # # # # # # # # # # # # # # # #
#   #   #   #   #   #   #   #   #
### ### ### ### ### ### ### ### #
#   #   #   #   #   #   #   #   #
# # # # # # # # # # # # # # # # #
#   #   #   #   #   #   #   #   #
### ### ### ### ###