   #####
   #   ####
   #  $   #
 ### # # # ####
##  $  # # #  ####
#  # $  # # $   #
# #  # $  $ # # #     ####
#  $ #  $   # # ##### #  ####
# #  # $  $ #        $      #
#  $ #  $   # #  ### #  #    #
##  # $  $  # ####  #####  $ #
 ### # # # ##    ###    ## # #
   #  $   #        #    $  $  #
   ## #### #### ##   # # # # #
    #      #    ######$ $    #
    ########       #@# #  $  #
            ########   #####