     ####
     #  #
     #  ####
     ##$.$ #
     #  .  #
     # $.$ #
     ## $ ##
     #  @ #
     # $.$#
     #  . #
     ##$.$#
     #  ####
     #  #
     ####