   #####
   #   #
   #   ####
 ###$     #
 #  $  #  #
 # # $##  #
 # #  .  .#
 #  #.##  #
 ##$ # $  #
  #  #  $ #
  #  # #  #
  #     $##
  ####   #
     #   #
     #####