  ############################
  # #   #   #   #   #   #   # #
  # # . # . # . # . # . # . # #
  # # $ # $ # $ # $ # $ # $ # #
  # # . # . # . # . # . # . # #
  # # $ # $ # $ # $ # $ # $ # #
  # # . # . # . # . # . # . # #
  # # $ # $ # $ # $ # $ # $ # #
  # # . # . # . # . # . # . # #
  # # $ # $ # $ # $ # $ # $ # #
  # # . # . # . # . # . # . # #
  # # $ # $ # $ # $ # $ # $ # #
  # # . # . # . # . # . # . # #
  # # $ # $ # $ # $ # $ # $ # #
  # # . # . # . # . # . # . # #
  # # $ # $ # $ # $ # $ # $ # #
  # # . # . # . # . # . # . # #
  # # $ # $ # $ # $ # $ # $ # #
  # # . # . # . # . # . # . # #
  # # $ # $ # $ # $ # $ # $ # #
  # # . # . # . # . # .