  ##############
  #   # # #    #
  # #.#.#.#.## #
  # $ $ $ $ $  #
  ###.#.#.#.#.##
   # $ $ $ $ $ #
###.##.#.#.#.###
#     $ $ $     #
# ##.#.#.#.#.## #
#  $ $ $ $ $ $  #
###.#.#.#.#.##.##
  #  $ $ $ $ $ #
  ##.#.#.#.#.###
  # $ $ $ $ $  #
 ##.#.#.#.#.## #
 #  $ $ $ $ $  #
##.#.#.#.#.##.###
# $ $ $ $ $     #
# ##.#.#.#.## ###
#  $ $ $ $ $  #
##.#.#.#.#.## #
 # $ $ $ $ $  #
 #.##.#.#.##  #
 #    @     ##
 ##############