    #####
    #   ######
    #   #     #
    #   #  $  #
  ###  $  $   #
  #  $ $ $  # ####
  #  $  $  ###  . #
### #### ###   . #
#  $  $    #  #  #
# $   ###### ##$####
#  $  #    $  $ $  #
#   ## ###  $  $   #
##### #  #### $  $ #
    # #.     $  $  #
    # #.  #  $  $  #
    # #### ## $  $ #
    #    $  #    $  #
    ###### #### $   #
         #     #   #
         ######   #
              ####