     #######
     #     #
     # $ $ #
     #  $  #
     ## # ##
     #  $  #
     # $ $ #
     ## # ##
   #### # ####
   #  $ . $  #
#### # # # # ####
#   $ . . . . $   #
# # # # # # # # # #
# $ . . . . . . $ #
# # # # # # # # # #
#   $ . $@$ . $   #
#### # # # # ####
   #  $ . . $  #
   #### # ####
     ## # ##
     # $ $ #
     #  $  #
     ## # ##
     #  $  #
     # $ $ #
     #     #
     #######