      #####
      #   #
      #   #######
      # $ $ $ $ #
      #  . . .  #
      ### # # ###
        # .$. #
      #### # # ####
      #   $ $ $   #
      #   .@. .   #
    ### # # # # ###
    #   $ $ $ $ $   #
    #   . . . . .   #
    ### # # # # # ###
      # $ $ $ $ $ #
      # . . . . . #
      ### # # # ###
        #   $ $ #
      #### # # ####
      #   $ $ $   #
      #   . . .   #
      ### # # ###
        # .$. #
      #### # ####
      # $ $ $ $ #
      #  . . .  #
      # $ $ $ $ #
      #   #####
      #####