   #####
   #   #####
 ### # #   #
 #   # # # #####
 # # # # # #   #
 # #   # # ##$###
## ### # #  .$. #
# $   $ #  #.#. #
#  # #  #    .  #
# #   # #  # # ###
#  # #  # # #   #
##$### ##$### # #
#   #   # #   # #
# # # # # # # # #
# #   # #   # # #
# # # # # # # # #
# # .  .  # #   #
#  #.#.#  #   $ #
###$## # ### ##$##
  #   # #   #   #
  #####   # # ###
        #####