    #######
    #  #  #
    # # # #
    ##   ##
     # # #
  ####   ####
  #  ## ##  #
### #   # ###   ######
#  $  $  $  #   #  ...#
# # #.#.#.# #   #  ...#
#  $  $  $  #   #  ...#
#####   #####   ######
    # # #
    ## ##
    #   #
    # @ #
    #####
