#####################
##  #  #  #  #  #  ##
#  $.$.$.$.$.$.$.$  #
# # # # # # # # # ##
# $.$.$.$.$.$.$.$.$ #
# # # # # # # # #  #
# $.$.$.$.$.$.$.$.$#
# # # # # # # # #  #
# $.$.$.$.$.$.$.$.$ #
# # # # # # # # #  #
# $.$.$.$.$.$.$.$.$#
# # # # # # # # #  #
# $.$.$.$.$.$.$.$.$ #
# # # # # # # # #  #
# $.$.$.$.$.$.$.$.$#
# # # # # # # # #  #
# $.$.$.$