    #####
    #   #######
    # $  #  #.#
    # $  $  #.#
    # $.$ $ #.######
    #  $ $  #.#    #
  ### .$ $. #.#    #
  #   $ $   #.#    ###
### # $ $ $ #.########
#   #  .$ $. #       #
#   # #     #   @    #
#####       #########
    # #     #
    # #######
    #
    #