#################
#  #  #  #  #  #  #
# # # # # # # # # #
#  #  #  #  #  #  #
# # # # # # # # # #
#  #  #  #  #  #  #
# # # # # # # # # #
#  #  #  #  #  #  #
# # # # # # # # # #
#  #  #  #  #  #  #
# # # # # # # # # #
#  #  #  #  #  #  #
# # # # # # # # # #
#  #  #  #  #  #  #
# # # # # # # # # #
#  #  #  #  #  #  #
# # # # # # # # # #
#  #  #  #  #  #  #
# # # # # # # # # #
#  #  #  #  #  #  #
# # # # # # # # # #
#  #  #  #  #  #  #
# # # # # # # # # #
#  #  #  #  #  #  #
# # # # # # # # # #
#  #  #  #  #  #  #
# # # # # # # # # #
#################