 ####
##  ##
#    #
# .$.#
#  $ ####
###.#   #
  # $$  #
  #  #  #
  #  # ##
  #### #
     # #
  ##### #
  #     #
  #  ## ###
  #  $    #
  # .#   @#
  #  ######