  #########################
  #  #  #    #  #    #  #  #
  #  #  #  #  #  #  #  #  #
  #  #  #  #  #  #  #  #  #
  #  #  #  #  #  #  #  #  #
  #  #  #  #  #  #  #  #  #
  #  #  #  #  #  #  #  #  #
  ## ### ## ## ### ## ### #
  #  #  #  #  #  #  #  #  #
  #  #  #  #  #  #  #  #  #
### ### ## ## ### ## ### ##
#  #  #  #  #  #  #  #  #  #
#  #  #  #  #  #  #  #  #  #
#  #  #  #  #  #  #  #  #  #
#  #  #  #  #  #  #  #  #  #
#  #  #  #  #  #  #  #  #  #
#  #  #  #  #  #  #  #  #  #
#  #  #  #  #  #  #  # 