    #####
    #   #
    #   #
  ### ###
  #  $  ####
### # ###  #
#  $  $ $  #
#  #.#.#.# #
#  $  $ $  #
#  ### ### #
####  $  #  #
   #   @  #  #
   #       ##
   #########