      #####
     ##   #
     #  $###
     #  $  #
     ## #$.#
    ##  .$.##
    #  . .  #
    # #.$.$ #
#### $.$.$ # ####
#   $.$.$ # #  #
#  . . . . .  #
### #.$.$ # ###
  #  . .  #
  ## #.$.#
  ##  $ ##
   # $  #
   ###$ #
    # @ #
    ######