    ####
    #  #######
    #  $ $ $ #
    ## .$.$. #
##### $ $ $ #
#   $  .$  ##
# #  $ .$ #
# ##  .$ #
#  ##### #
##      #
 ####  ##
    #  #
    #  #
    #  #
    ####