   #######
   #     #
   #     #
   #     #
   #     ######
   #         .#
####  ######.###
#  ###        $#
# @ $          #
#  ###  ########
####  ###
   #  $  #
   # $ ###
   #.######
   #. . .#
   # $$$ #
   #  .  #
   # $$$ #
   #  .  #
   # $$$ #
   #  .  #
   # $$$ #
   #  .  #
   # $$$ #
   #  .  #
   # $$$ #
   #  .  #
   # $$$ #
   #######
