#############################
# #     #   # # # #   #     #
# # # # # # # # # # # # # # #
# $ $ $ $ $ $ $ $ $ $ $ $ $ #
# $.$.$.$.$.$.$.$.$.$.$.$.$ #
# $ $ $ $ $ $ $ $ $ $ $ $ $ #
# $.$.$.$.$.$.$.$.$.$.$.$.$ #
# $ $ $ $ $ $ $ $ $ $ $ $ $ #
# $.$.$.$.$.$.$.$.$.$.$.$.$ #
# $ $ $ $ $ $ $ $ $ $ $ $ $ #
# $.$.$.$.$