    #####
    #   #
    # $ ####
  ###$ $ $ #
  #  $ # # #
### # # # # ####
#   # # # # #  #
# $$$  $ $  $   #
#   # # # # # $ #
##### # # # # # #
    #       #   #
    #########   #
            #@# #
            ####