#############################
#  #  #  #  #  #  #  #  #  #  #
#  #  #  #  #  #  #  #  #  #  #
#  #  #  #  #  #  #  #  #  #  #
#  #  #  #  #  #  #  #  #  #  #
# # # # # # # # # # # # # # # #
# # # # # # # # # # # # # # # #
# # # # # # # # # # # # # # # #
# # # # # # # # # # # # # # # #
# # # # # # # # # # # # # # # #
# # # # # # # # # # # # # # # #
# # # # # # # # # # # # # # # #
# # # # # # # # # #