 ######
##    #
# .$. ##
# $.$ #
## $  #
 # .$ #
 # .$ #
 #  $ #
 ##   #
 ######