  ####
###  #
#  $ #
# $  #
#  $ #
## $ #
#@ $ #
#####