  #####
 ##   #
 #  $###
 # $ $ #
### .$.#
# $.$ #
# $ $ #
#  $  #
### ###
# $ $ #
# .$. #
# $$$ #
#  $  #
### ###
 # .$.#
 # $ $#
### $ #
#   $  #
#####  #
   ####