      #####
      #   #
      #   #
      # # #
      # # #
    ### ###
    #     #
    # # # #
    # $ $ #
  ###.$ $.###
  #   . .   #
### # $ $ # ###
#   #     #   #
#   ### ###   #
#####   #####