    #####
    #   #
    #.# #
  ###$ $###
  #  .$.  #
### # # # ###
#   .$. .$.   #
# # # # # # #
#   . .@. .   #
### # # # ###
  #  .$.  #
  ###$ $###
    #.# #
    #   #
    #####