  ################
  #   #          #
  # # # # # ###  #
  #   #     # #  #
  # $   #   # #  #
  # .$  #####$$  #
  # $ $ # #  #   #
  #  .$.# #  #   #
  ##$ $ ###  #####.#
 ##  $  #  $  $   .#
 #  .$. #  ##$ $ ##.#
 # $ $ ##$ #  $  $  #
 #  $   # #  #.$.$  #
 ##$##### ### $ $ ##
  #  # #  #  $   $  #
  #  # #  #   #   $ #
  #  # #  ### # #   #
  #  #     #   # #  #
  #  ### # #     #  #
  #  #   # #   #   $ #
  #  #   # #   #  $  #
  #  #   # #   #####.#
  #  ##### ###  $  $ #
  # $   #  $  # ##$ $ #
  #.$.$ #  ## #  .$  .#
  # $ $ ### $ ##### $ #
  #  $   #  $     #   #
  #  # # #  #     # # #
  #  # # #  # ### # # #
  #          #   #   #
  ################