    #####
    #   ######
    #       .#
    #  ## ##.###
    ##$ # #. . #
    # $  # . # #
    #  # #   . #
    ## #  $##$##
    #  #$  #  #
    # .  # . $#
    # .## # $ #
    ####. ##  #
      #.## ## #
      #.       #
      #. #######
      #. #
      #. #
      #  #
      ####