  ############################
###    #  ##  # ##  #     ####
#   $  #  #  $  #  #  $  $   #
#  #  $  $  #  $  $  #  #  #  #
# $  #  #  $  #  $  #  $  $  #
##  $  $  #  $  #  $  #  $  ##
# $  #  #  $  #  $  #  $  $  #
#  #  $  $  #  $  $  #  #  #  #
#   $  #  #  $  #  #  $  $   #
###    #  ##  # ##  #     ####
  ############################