  ############################
  #                          #
  #  #######  #######  ####  #
  #  #     #  #     #  #  #  #
  #  #  #  ####  #  #     #  #
  #  #  #     #  #  #  #  #  #
  #  #  #  #  #  #  #  #  #  #
  #  #  #  #  #  #  #  #  #  #
  #  #  #  #  #  #  #  #  #  #
  #  #  #  #  #  #  #  #  #  #
  #  #  #  #  #  #  #  #  #  #
  #  #  #  #  #  #  #  #  #  #
  #  #  #  #  #  #  #  #  #  #
  #  #  #  #  #  #  #  #  #  #
  #  #  #  #  #  #  #  #  #  #
  #  #  #  #  #  #  #  #  #  #
  #  #  #  #  #  #  #  #  #  #
  #  #