 #######
 #     ###
 #  $ $ ##
## $.$.$ #
#  $.$.$ #
## $.$.$ #
 #  $ $ ##
 #     ###
 #########