  ####### #########    #########
 ##     ###     ###    ###     ##
 #  $.$.$ # $.$.$ #    # $.$.$. #
 #  .#.#.###.#.#.######.#.#.#.  #
 # $.$.$.$.$.$.$.$.$.$.$.$.$.$. #
 ##.###.#.#.#.#.#.#.#.#.#.#.###.#
 ##  $.$.$.$.$.$.$.$.$.$.$.$.$  ##
 #  .#.#.#.#.#.#.#.#.#.#.#.#.#.  #
 # $.$.$.$.$.$.$.$.$.$.$.$.$.$. #
 ##.###.#.#.#.#.#.#.#.#.#.#.###.#
 ##  $.$.$.$.$.$.$.$.$.$.$.$.$  ##
 #  .#.#.#.#.#.#.#.#.#.#.#.#.#.  #
 # $.$.$.$.$.$.$.$.$