 #######
##     ##
#  # #  #
#  .$.  #
#  #.#  #
## $ $ ##
#  #.#  ##
#  .$.   #
#  #.#   #
## $ $   #
#  #.#   #
#  .$.   #
#  #.#   #
## $ $   #
#  #.#   #
#  .$.   #
#  #.#   #
#  .$.   #
#  #.#   #
## @.@   #
##########