 #######
 #  #  ##
##  $ $ #
# .#.#  #
#  $.$ ##
## #.#  #
 # $ $ ##
 ##   # #
  ##  @ #
   ######