 #####
##   ##
#  $  #
# .$. #
## $ ##
 ##@##
 #####
