      #####
      #   #
      #   #
######   ####
#   ## ... #
#  $ $.$  #
# #  #. $ #
#  $$.$ # #
##$.$ $  ##
 # . #  #
 #.  #  #
 ######  #
      ####