    #######
    #     ##
##### ### ##
#     #   #
# $ $ $ . #
#  # # . ##
##   $ . #
 ###  # ##
  ##$  #
  #  $ #
  #    #
  ######