  #######  
 ##     ## 
##  #  #  ##
#   # #   #
#  #   #  #
## #   # ##
 ##  #  ## 
 ###   ### 
  ##   ##  
  ##   ##  
  ##   ##  
  ##   ##  
  ##   ##  
  ##   ##  
  ##   ##  
 ###   ### 
 ##  #  ## 
#  #   #  #
#   # #   #
#  #   #  #
## #   # ##
 ##  #  ## 
  #######  