    #######
    #     #
    # # # #
  ### # # ####
  #   # #    #
### # # # ## #
#   # # # ## #
# # # # # ## #
# # # # #  $ #
# $  .  #   . #
###############
      #     #
      #######