    #######
    #     ###
    # .$. . ##
  ### # # # ##
  #  ### ### ###
### # $ $ $ $ ##
#  ### # # # $ ##
# $ $ $ $ $ .  #
## $ # # # ### #
 ##  ### ###  ##
  ## # # # ### #
  ## # # # ### ##
  #  $ $ $ $ $ ##
  ## $ . $ .$. #
  ### ### ###  #
    ## # # #  ##
    ## ### ### #
    ##  @    #  #
    ########### 