        #####
        #   #
######### # #
#  $ $ $  # #
# #.#.#.# # #
#  $ $ $  # #
# #.#.#.# # #
#  $ $ $  # #
## # # #  # #
 # # # ######
 #   #  #
 #####  #
     ####
     #  #
     #  #
     ####
     #  #
     #  #
     ####
     #  #
     #  #
     ####
     #  #
     #  #
     ####
     #  #
     #  #
     ####
     #  #
     ######