     #####
     #   #########
##### # # #       #
#   # # ###$ $ $  #
# #  $ $  #  #.##.#
#  $ #.## #  #.##.#
##$  .##  ####.##.#
 #  ##  ###  #.##.#
 # ##  #  #  #.##.#
 #   $ ## #  #.  .#
 ###$  #  ####  $ #
   #  ###    ######
   #####