  #######
 ##     #
 #  #   #
 #  $ $ #
## #.#.#.##
#  $.$.$.$#
# #.#.#.#.##
# $.$.$.$.$#
# #.#.#.#.#.##
# $.$.$.$.$.$#
# #.#.#.#.#.#.##
# $.$.$.$.$.$.$#
## #.#.#.#.#.#.##
 # $.$.$.$.$.$.$#
 # #.#.#.#.#.#.##
 #  $.$.$.$.$.$.$#
 ## #.#.#.#.#.#.##
  #  $.$.$.$.$.$.$#
  # #.#.#.#.#.#.##
  #  $.$.$.$.$.$.$#
  ## #.#.#.#.#.#.##
   #  $.$.$.$.$.$.$#
   ## #.#.#.#.#.#.##
    #######@#######