    #######
    #     #
    # $ $ #
  ### .#  ##
  #  .$.  #
### #.# # ##
#  $ . .  #
# # #.# ###
#  . . $ #
## #.# # ###
 #  .$.  #
 ## # .  #
  #  $ $ #
  ##  #.###
   # $ $ #
   #     #
   #######