      #####
      #   #########
      # $  $ $ $ $ #
      #  $ $ $ $ $ #
     ## $ $ $ $ $ #
     # $ $ $ $ $ $ #
##### $ $ $ $ $ $ #
#   # $ $ $ $ $ $ #
#   ##$ $ $ $ $ $ #
#    # $ $ $ $ $  #
#    ## $ $ $ $   #
#     # $ $ $ $   #
#     ## $ $ $    #
#      # $ $ $    #
#      #######    #
#########   #######
        #   #
        #####