            #####
            #   #
############## # #
#    #     #   ## ####
# $  $  $  #           #
# # ### ## #  #######  #
#  #     # ####   #####
##  ###  #    ###
 #### ####  ###
    #      ##
    #      #
    #.     #
    #@     #
    #.     #
    #      #
    #########