    #####
    #   #
  ###$  #
  #  .  #
### # # ####
#  $  $    #
# # # ##$  #
# $ $ .  # #
#  #  $  $ #
## $### # ##
 #  $  #  #
 ## # ##$ #
  #  $ .  #
  # $ $  ##
  ###### @#
       ####