###  #########  ####
#   ##     ####  ##
#   ## $ $ $ ##   #
#  ##  $.$.$.  #   #
# ## $.$.$.$.$#   #
# #  .$.$.$.$ ##  #
#  # $.$.$.$.$ #  #
#  #  .$.$.$.$ ## #
# ## $.$.$.$.$.$  #
# #  .$.$.$.$.$ ## 
#  # $.$.$.$.$.$ # 
#  #  .$.$.$.$.$ ##
# ## $.$.$.$.$.$  #
# #  .$.$.$.$.$ ## 
#  # $.$.$.$.$.$  #
#  ## $.$.$.$.$  ##
#   #  .$.$.$.$ ## 
#   # $.$.$.$.$ #  
#   ## $.$.$.$ ##  
#    #  .$.$.$ ##   
#    ## $.$.$ #    
#     ##  $  ##    
#      ##   ##     
#       #####      
#         #        
#         #        
#         #        
#         #        
#         #        
#         #        