       #####
       #   #
 #######   ########
## $    ## #  ##  #
# $ $    #    # . #
#  $  ## #    # . #
#  #  #  ######. ##
##  # #  #    #. #
 #  # ####    #. #
 #  # #  ######. #
 # ## #  #    #. #
 ##  ##  #    #  #
  #  ##  #    $ ##
  #    # #    $ #
  ##    # #    $ #
   #  ## ####   #
   # ##  #  #####
   ##  $ $ $ #
    #  $ @ $ #
    #  $ $ $ #
    ##########