###  ####################### 
#     #   #   # #   #     #
# $ $ ## ### ### ### $ $  #
## #  .##  #   #  ##.  # ##
# $  ##  #     #  ##  $  #
#  #  ## #  #  # ##  #  #
#  $ $  #  #  #  #  $ $  #
#   @   #  #  #  #   @   #
###########################