# # # # # # # # # # # # # # # # # # # # # # # # # # #
#                                                   #
#  ###### ##### ####### ########## ##### ######  #####
#  #   # ##### #  #  #  #  #####  ##### #   ##  #   #
#  #  $  #   # #  #  #  #  #   #  #   # #  $  #  #  #
#  ## ###   ###  #  #  #   ## ###   ## ### ## ##  ##
#  #  #  #  #  ## ### ##  #  #  #  #  #  #  #  #  #
#  #  $  #  #  #  #   #  #  #  $  #  #  $  #  #  #
#  ## ###   ## ## ## ## ##  ## ##   ## ### ## ##  #
#  #  #  #  #  #  #  #  #  #  #  #  #  #  #  #  #  #
#  #  $  #  #  #  #  $  #  #  $  #  #  $  #  #  #
#  ## ###   ## ## ## ## ##   ## ##   ## ### ## ##  #
#  #  #  #  #  #  #  #  #  #  #  #  #  #  #  #  #  #
#  #  $  #  #  #  #  $  #  #  $  #  #  $  #  #  #
#  ## ###   ## ## ## ## ##   ## ##   ## ### ## ##  #
#  #  #  #  #  #  #  #  #  #  #  #  #  #  #  #  #  #
#  #  $  #  #  #  #