###  #####  ###  #####  ###
#    #   #### ####   #    #
# #  # #       @ # #  #  @ #
#  ## #  ##  # # ##  # ##  #
##  #  #  #### ####  #  #  ##
 #  #  #  #  # #  #  #  #  #
 #  #  #  #  # #  #  #  #  #
 #  #  #  #  # #  #  #  #  #
 #  #  #  #  # #  #  #  #  #
 #  #  #  #  # #  #  #  #  #
 #  #  #  #  # #  #  #  #  #
 #  #  #  #  # #  #  #  #  #
 #  #  #  #  # #  #  #  #  #
 #  #  #  #  # #  #  #  #  #
 #  #  #  #  # #  #  #  #  #
 #  #  #  #  # #  #  #  #  #
##  #  #  #  # #  #  #  #  ##
#  ##  #  #  # #  #  #  ##  #
# #  #  #  #  #  #  # #  #  #
#    ####  #  #  ####    #  #
###  #####  ###  #####  ###