  #######
 ##     #
 #  $ $ #
## $.$  ##
#  $.$ $ #
# $.$.  ##
## $.$  #
 # $.$ ##
 ## $  #
  ##   #
   ##  #
    ## ##
     #  #
     #  #
    ##  ##
    # $$ #
   ##  $ ##
   #  $. ##
  ##  $.$ #
  # $.$.  #
 ##  $.$ $#
 #  $.$ $ #
 # ##  $.$#
##  $.$ $ #
# $.$  ## #
#  $.$ $  #
##  $.$ $ #
 #  $.$  ##
 ##  $ $ #
  ## $ $ #
   #     ##
   #######