 #######
##     ##
#  $$$  #
# #.#.# #
# $.$.$ #
## # # ##
 #  $  #
 # #.# #
 # $.$ #
 ## # ##
  #   #
  ##@##
   # #
   #.#
   # #
   # #
   # #
   #.#
   # #
   # #
   ###