###  ###########  ########
#    #         #  #     #
# $  # $ $ $ $ #  # $ $ #
#  $ #  . . .  #  #  . . #
# $  #  . . .  #  #  . . #
#  $ #  . . .  #  #  . . #
# $  #  . . .  #  #  . . #
#  $ #  . . .  #  #  . . #
# $  #  . . .  #  #  . . #
#  $ #  . . .  #  #  . . #
# $  #  . . .  #  #  . . #
#  $ #  . . .  #  #  . . #
# $  #  . . .  #  #  . . #
#  $ #  . . .  #  #  . . #
# $  #  . . .  #  #  . . #
#  $ #  . . .  #  #  . . #
# $  #  . . .  #  #  . . #
#  $ #  . . .  #  #  . . #
# $  #  . . .  #  #  . . #
#    # $ $ $ $ #  # $ $ #
###  ###########  ########