# #######  ###########  #
#       ####         ####
# @   $  ##  #####  $   #
## # ##  ##  #   #  # # ##
# $ $ ####  # .$. # #### #
## # ##  ####   ####  $  #
# $ $  #  ## .$. ##  # # #
## # # #  #  $ $  #  ##  #
# $   $  #  #   #  ## # ##
#  ###  ##  #####  ## # #
# ##  ####         ##   #
#  #######  ###########  #
##########################