    #######
    #     ##
    # # #  #
  ### # ## #
 ##  $ $  #
## # .$. ##
#  ## .$. #
# #  $ $  #
# # ## # ##
#  ## # # #
##  # # # #
 ###   # #
   ##    #
    ######