#########   #########   #####
#       #####       #####   #
# $ $ $ $ $ $ $ $ $ $ $ $ $ #
# $.$.$.$.$.$.$.$.$.$.$.$.$.#
# $ $ $ $ $ $ $ $ $ $ $ $ $ #
# $.$.$.$.$.$.$.$.$.$.$.$.$.#
# $ $ $ $ $ $ $ $ $ $ $ $ $ #
#       #####       #####   #
#########   #########   #####