##########  #######   ########
#  #     ##  ##   ##   #     ##
# $ $ $  ##  ##   ##   # $ $  #
# . # .  ##  ##   ##   # . # .#
# $ $ $  ##  ##   ##   # $ $  #
## . # . ### ##   ## ### . # .#
 ## $ $ $  #  ##   ##  # $ $  #
  ##     #  #  ##   ##  #     ##
  ##########    ########    ####