           #######
           #     #
 ###########     #######
 #         ##$ $  $    #
 #  $ $ $ $   # # # #  #
 # # # # #  $ $ $ $ $  #
 #  $ $ $ $ # # # # #  #
 # # # # #  $ $ $ $ $  #
 #  $ $ $ $ # # # # #  #
 # # # # #  $ $ $ $ $  #
 #  $ $ $ $ # # # # #  #
 # # # # #  $ $ $ $ $  #
 #  $ $ $ $ # # # # #  #
 # # # # #  $ $ $ $ $  #
 #  $ $ $ $ # # # # #  #
 # # # # #  $ $ $ $ $  #
 #  $ $ $ $ # # # # #  #
 # # # #