      #####
      #   #
      #   #
      ## ##   #######
     ##  #####     #
    ##  ##   $  $  .#
    #  ##  ##$# $$.###
    # ##  ## # $ $  ##
    ##  ####  # $ $  #
     ###  ######$ $  #
       ##  #    $ $$ #
       #  ## ##$#$ $ ##
       # ##  # # $ $  #
       # #  ## # $ $  #
       #  ##  ##$# $$.#
       ##  ##   $  $  .#
        ## #####     ##
         #######   ## #
               ## ##  #
               #   #  #
               #   # ##
               #####  ##
                    #  #
                    #  #
                    #  #
                    #  #
                    #  #
                    ####