 #######
 #     #
 #     #
## ### #
#  $ $ #
# # .# #
#  $ $ #
## ### #
 #     #
 # . . #
 # $ $ #
 # . . #
 # $ $ #
 # . . #
 # @   #
 #######