 #######
 #     #
## $.$ ##
#  #.#  #
# $ @ $ #
#  #.#  #
## $.$ ##
 #  $  #
 #######