 #######
##     ##
# $. $. #
#  # #  #
##  $  ##
#  # #  #
# $. $. #
##  @  ##
 #######