#########  #########   ####
#       ####       #####  #
# $ $ $ $ # $ $ $ $ # $ $ #
#  #.#.#  #  #.#.#  #  #.#.#
## # # ## ## # # ## ## # # ##
 # #   # # # #   # # # #   # #
 #  #$  # #  #$  # #  #$  #  #
 ## # # ## ## # # ## ## # # ##
 #  #.#.  #  #.#.#  #  #.#.#.#
 # $ $ $ # $ $ $ $ # $ $ $ #
##       #####       #####  #
#   #####  #########  ########
#####   ####       ####
    #####  #       #
         ##         #