  #####
###   ###
#  .$.  #
# .$.$. #
##$...$##
# .$.$. #
# .@.@. #
##$...$##
# .$.$. #
#  .$.  #
###   ###
  #####  