###########  #####  ##########
#    #    ####   ####       #.##
#    # $  #  ## $   ##  $     . #
#   $  ####  #  #  $ ##  # $ .  #
#  $  #  #  ##  #   ##  ##  # $ #
# $  ##  #  #  ##  #  #  ##  #  #
#  #  #  ##  #  ## #  #  #  ##  #
##  ##  #  ##  #  ##  #  ##  #  #
#  ##  #  ##  #  ##  #  ##  #  ##
#  #  ##  #  ##  #  ##  #  ##  #
#  ##  #  ##  #  ##  #  ##  #  #
##  #  ##  #  ##  #  ##  #  ##  #
#  ##  #  ##  #  ##  #  ##  #  #
#  #  ##  #  ##  #  ##  #  ##  #
#  ##  #  ##  #  ##  #  ##  #  #
##  #  ##  #  ##  #  ##  #  ##  #
#  ##  #  ##  #  ##  #  ##  #  #
#  #  ##  #  ##  #  ##  #  ##  #
#  ##  #  ##  #  ##  #  ##  #  #
##  #  ##  #  ##  #  ##  #  ##  #
#  ##  #  ##  #  ##  #  ##  #  #
#  #  ##  #  ##  #  ##  #  ##  #
#  ##  #  ##  #  ##  #  ##  #  #
##  #  ##  #  ##  #  ##  #  ##  #
###########  #####  ##########