    #######
    #  ...#
    # #$$ #
  ### # $ ##
  #   # $  #
### # ## $ #
#  $ $ .#  #
# #  $ .   #
#  $$ . #  #
#  ... @  ##
###########