    #######
    #     ##
    # # # ##
    # . .  ##
  ###$ $ $  ##
  #  . . . . ##
###$$ $ $ $ $ ##
#  . . . . . . ##
# # # # # # #  ##
#         @    ##
##################