 #######
##     ##
#  # #  #
#  .$.  #
# # . # #
#  # #  #
##  @  ##
 ########
  #   #
  #   #
  ###.###
    #.#
    #.#
  ###.###
  #   #
  #   #
  #####