     #####
     #   ####
 ##### #   ##
 #   ### $$ #
 # # $ $   ##
## ## $$ #  #
#   #  # .# ###
# # #  #. . .#
# # #### .  @#
# #    ##. . #
### ### #### #
  #     #    #
  #######    #
        ######