 #######
 #     ##
 #. #   ##
##$ $  . #
#  #  ##.##
# $ $ $ $ #
##  #  #  #
 # .  $ $ #
 ##   # . #
  #########