      #####
      #   ###########
      #   #         #
      #   #  $ $ $  #
      ## ##   . . . #
     # $ $ #  . . . #
     #  .  ###. . . #
     ## # ##  . . . #
      #  $   ##. . ###
      #   ##  . . . #
      #  #  #  . . . #
      ##    #  . . . #
       ###### . . . #
            ##. . . #
            #  . . .#
            #  . . .#
            #  . . .#
            #  . . .#
            #  . . .#
            #  . . .#
            #  . . .#
            #  . . .#
            ##########