 #####
 #   #
 #   ######
## #      #
#  $ $ $  #
# # . . . #
#  $ $ $  #
#  . . .@ #
###########