   ####
   #  #
 ###  ###
 ##    ##
 #  $$  #
 # #. .# #
 ## ...##
  #. .. #
 ## ...##
## .$. ##
#      @#
###  ## ###
  #  ##  #
  ####  #