            #####
            #   #
      ####### # #
      #  $ $  # #
      #  .+.  # #####
      ##...####    ##
       #. @ .#      #
 #######.....#      #
 #     #. $ ###   ####
 #     #    $ #####  #
 #     #. $ $      # #
 #######         #   #
       ###########   #
             #       #
             #########