   ####### ######
  ##     ###    #
  # $  $ $ $ #  #
 ##  #. . .  #$ #  #####
 #  # ....# #   ####   #
 #  #  ... # $  $   $  #
 #  # .... #  #   # #  #
 #  #  . . # $# $  . . ##
 #  #$     #   #  #.#  #
##  #@###### #  $  .  #
#  ###      . #    #  #
#    #########      ##
####                #
   ################