    #######
    #  #  #
    # ### #     ######
   ##  $  #######   ##
   #  $ $  $ $ $  #. #
  #  .$.$.$.$.$  #.  #
  # #  $ $ $ $  #.#  #
 ##.############.  #
 # .  $ $ $ $ $  ##
 #  # .$.$.$.#  #
##   #.  @  .# ##
#  #. #  $ #. #
# .  #   $ #  #
#. #######  $  #
#.         ##  ##
######     # ### #
    # ###  ## #  #
    #  #  ### #  #
    #######  # ####
          ###