      #####
      #   #
    ### # ###
    #  .$  #
  ### # # #####
  #  . $ .     #
### # # # #@###
#     . $ .  #
# ##### # ####
#  . $  . #
# ### # ### 
# # $ #  #
#   # #####
#####