   ######             
   #   @#  ###########
   #   ####          #
   #     $     $ $   #
   #    #.#######.#####
   #####..#    #. $   
   #    ..#    #...#  
   #    #.###### #.###
   #    $ $     #... #
   #      $     $ $  #
   ###   ########.## #
   ######         ####
       #         #    
       #         #    
       #          #  
       ############