  ########
 #### . ###
 #   $.$@#
 #  $.$  #
## $.$$ ##
# $.$  $ #
# $  #   #
#   #### #
###  ####
  ####