        ####
 ########  ####
 #      # $   #
 # # ##.##   # #
 #   . $ ## # #
## #. ##    # #
#  $..#  #  # #
# #. ## # ##$  #
#    ##.   #   #
##@#   $ ## # ##
 #   #. ## $  #
 # #    ## .# #
 # # ##    .  #
 #   $ .## ## #
 ####  $   #  #
    ####  ########
       ####