#################
#               #
# .$     .$     #
# $ $     $     #
##  ###  #  #####
 # #  #  ###   @#
 # ####  #  #  ##
## #  #  ###  # #
#  # .##  #  #  #
# $  $ # $ $ $  #
#     .           #
####  ####.  #####
   ####    .####
      # $$$.#
      #      #
      #     $ #
      #. #### #
      #  #    #
      #.####. #
      #     $ #
      #   #    #
      ### #.  #
        #    ##
        ##  ##
         ####