  ####     #####      ####   ######   ######    #####
  #  #     #        #  #   #  #          #      #     
  #  #     ###      #  #      #####      #      #  ###
  #  #     #        #  #      #          #      #   #
  #  #  #  #        #  #   #  #          #      #   #
 ## ##   ###         ## ##   ######      #       #### 