          ####
      #####   #
      #      # #
      # #  #  ###
    #### ##$ $  #
    #  ### .#$# ####
    #         .# # #
    #   ######.    #
  ####    #  #$$#  #
  #     #  $  #  #####
#### # @ #   ##     $ #
#    #   #### ## #   . #
#  $  ###   # #  #####  #
#.#$         # #   #   ##
# $#.         #  $$$ # #
#  ###  #  #  #    #   #
###  ####  ## #####  $ #
  # $##.  $ $ ##  # $  #
  #   ##  # #. ###  ####
  ######.    #####
       # .####
       #   #
       #####