            #####
            #   #
      ####### # #
      #  $ $  # #
      #  $#$  # #            #####
      #  $.$  #       #########  #
      #  $.$  ####### #  $    #  #
      #    $  #   #   #.$.$   #  #
    ###       #  $.  #.$.$  # # ##
    #   #   ###  #.#  #.$.$  #  #
#####  ##     # ##.#  #.$.$  #  #
#   #  #  ...   #.#  #.$.$  #  #
# $  $    ...   #.#  #.$.$  #  #
#  ##  #. ... @ #.#  #.$.$  #  #
#     $# .....  # #  #.$.$  #  #
#     ##$ .....   ###$.$   #  #
#      # $ .....    # $    #  #
#     ## $      ##  #  ####   #
##    #  ########  ##       ####
###   #             #########
  ########          #      ##
         ########   #       #
                #####       #
                    #       #
                    #       #
                    #       #
                    #       #
                    ####  ####
                       #  #
                       #  #
                       #  #
                       #####