 #####  #####
 #   ####   #
## #$. .$ # #
#    . .    # 
#  $  .  $  #
## $ $@$ $ ##
#  $  .  $  #
#    . .    # 
## #$. .$ # #
 #   ####   #
 #####  #####