  #####
  #   #   ######
### # ####    #
#   # #   # . ##
# $  $    #####  #####
###$#$####     ##   #
  # $  $ #  ### ## . #
  ###$#$  $##  #   ##
    # $  $  #### #####
    ###$#$  @ $  #
      #   ### ## #####
      ##  #  $  $ #
       ##### $ $###
          # . ##  #
          #    #####
          ######
