   #####
   #   #
 ### . ###
 ##     ##
 #   .   #
 #   $   #
 #       #
 ####@####
 ### . ###
   # # #
   ###