#############################
#                           #
# .$.$.$.$.$.$.$.$.$.$.$.$. #
# $.$.$.$.$.$.$.$.$.$.$.$.$ #
# .$.$.$.$.$.$.$.$.$.$.$.$. #
# $.$.$.$.$.$.$.$.$.$.$.$.$ #
# .$.$.$.$.$.$.$.$.$.$.$.$. #
# $.$.$.$.$.$.$.$.$.$.$.$.$ #
# .$.$.$.$.$.$.$.$.$.$.$.$. #
# $.$.$.$.$.$.$.$.$.$.$.$.$ #
# .$.$.$.$.$.$.$.$.$.$.$.$. #
# $.$.$.$.$.$.$.$.$.$.$.$