   #######  ####
   #  #  ####  #
 ###.$.$.$.$.$###
 # $.$.$.$.$.$ #
 # $.$.$.$.$.$ #
 ##$.$.$.$.$.$##
  # $ $ $ $ $ #
###  $ $@$ $  ###
#    $ $ $ $    #
### $ $.$.$ $ ###
  #  $.$.$.$  #
  ####  ####  #
    ####  ####