     ####
     #  #
     # ##
   ###$ ####
  ##  . $  #
### .    # # ####
#  .  ##  ###  $ ####
#   #### .  #   .  $ #
#  ##    .  ### ##   #
#### $  ###    .  # ###
   #  # #   .    ##
  ###  .$    .  ##
   ###    #  ####
     ####$###
       # ##
       # #
       ####