  ######    #######         ####    ####   #  ###########  #  ###### 
 ##    #####       ##########  #####    #######         ## #       #
 #   ..    #.###$#            # #  #      #      ########## #  # ##.#
 #  ...  #$$.$  # #### ## ## ## #### #### ## ## ## #       # ###    #
 #   ..  #.$..  #  #  #  #     #          #     #  #  ##### # #  #  #
 ##..    #.###  ###  ### #  #  #########  #  #  ### #  #    # #  #.##
 ###  ####.#      #  #     #  #         #  #  #     #  # ## # #    #
##  ###  #.####### ## #  #  ###  # # #  ###  ###  #  ###    # #  # #
#  ##   ##.#      #   #  #  #  #  # # #  # #  #  #  #  #  ## # ##  #
# #  $   #.##  ###### #  #  #  #  # # #  # #  #  #  #  # #  #    ###
#  #..#  #.#  ##    # #  #  #  #  # # #  # #  #  #  #  # #  ####. ##
##   $  #.##$##  .  # #  #  #  #  # # #  # #  #  #  #  # # #  #    #
 ###$####.#.$ # ..  # #  #########  # # #  #  ####  ##  # #  #  #  #
 #  ...  #.#.  #...$# #            #     #  #         #  #  #  #####
 # $.$   #.  #  ....  ##############  ##############    ##  #  #
 #    $$ #.          #               ##               ####  $  #
 ##  ##  ############ ################## ##############    ##  #
  ####                                                         ###
    ############################################################ 