   ###### #######
  ##    ###     #
  # $$      $ $ #
 ##. ##  ## .#. ##
 #..  ##  #...# #
 #..   @#  #...# #
##.. ## ## #.  # #
##..          #  #
 # $### ### ## $ #
 #  $  ### ###   #
 ###$##  #  ##$###
##    #  #  #   #
#            $$ #
#       ####   ##
#  #####    # ####
# ##   # ## # #  #
#  ##.## ## #    #
#    .# #  ##    #
#    .  #   ##   #
#    ..###  ##   #
#    ..# ######   #
#    ..# #   ##   #
##  # ## # # ######
## #    #   # ####
## ##### #####
###     ###
#########