           ########
           ########
           ########
           ########
           ########
           ########
           ########
           ###  $  #
           #  $.$  #
#############  ..$ #
# $    #   ## #  $  #
#  . . . #  ## ######
## . . .  $  #
 ## . . .# ###
  ## . . .#
   ##    $#
    #   $ ###########
    ###### ##########
           ########
           ########
           ########
           ########
           ########
           ########
           ########
           ########
           ########
           ########
           ########
           ########
           ########
           ########
           ########