       #######
  ######     #
  #   $ $ $  #
  #  $ # # $ ######
  #  $  #.$ $     #
  ##  $ #.# $  #  #
 ##  $  #.# $  #  #
 #  $   #.# $ ### #
 # $ $  #.#  $ #   ###
 #   #  #.# #  .     #
##     .   @  ## # #####
#   . #  #.# #     #     #
#  .  # #.$ #  $   #$$ $ #
##### #### $  # $  #  #  #
    #       $# $ $  #  #
    #         $   $  ##
    ##########     ##
              #######