 #####
##   ###########
# $ $ $ $ $ $  #
##.##.#.#.#.##.#
 # $ $ $ $ $  $ #
 #.#.#.#.#.##.##
 # $ $ $ $  # #
 ##.#.#.#.## #   ######
 ## $ $ $  # #####   @#
 ##.#.#.#.##       ####
 # $ $ $ $ ##
 #.#.#.#.# ##
 # $ $ $  $#
# .#.#.#.## #
#  $ $ $ $ #
###.##.#.#.# #
  #$ $ $ $ $ #
   ############