    #### #
    #  # #
    #  ### ###
    #    . .#####
    #   $ . .$  #
#####  ##...#  #
#   #   ##.#####
#       # #   #
#  ##   # #####
## # $$ $ #
 #  #  #  #
 #   #   ##
 #####  #  #
     #  ####
     ####
  ####  #
  #  #  ####
### ## $ ###   #####
#   # . .  #####   ##
#  $ $. $  #   $$  #
## #...##  # #   # #
 # #...##   $   $  #
 #  #..  @####    ##
 ####...  #   #   #
    ## #### ##  ###
    #  $ #   $ $ #
    #   # . .$   #
    #####. .    ##
        ### ####
          #  #
          #  #
          #  #
          ####