   #####
   #   #
   #   #
 ###   ###
 ## .$. ##
 #   #   #
 # $.$  $#
 ####$####
##### #####
#   # #   #
# $.$.$ $ #
### $.$ ###
  # .$. #
  ### ###
  #     #
  #     #
  ###@###
  #####