        #######
        #  #  #
  ######.##$.##
  ## $ $. $ ..#
  #   $   ##. ####
 #### ##   $ $ $ #
 # ..$ $## #.  #  #
##.#  $  # # $  # #
#..   #  #   #### #
#  ####  #.#$ ##  #
####  ####   $ $ ##
   #       #@#    #
   ########      #
         #  ######
         ####