###### #######
#    ## ######
#.$$. ## #####
#.$$.  ###  ###
#  #.  #  #  ##
## ##  . .  ###
 #  #  ..... ##
 # ## # ..... #
 # ## # ..... #
## ##  . .  ###
##  #  #  #  ##
###  ###  #####
#### ## ######
 #### ##  ###
    # @#  ###
    #### ####
    ###  ####