  #####
  #   ######
  #  $  $   #
  ## $#$  $ # ####
### $  $  ## #  #
#   $ $ ###     #   ####
#  ## $ # # # # #### $ ###
##  ###. .  $  ##    $ $  #
 # #  .. .####  ####$$   #
 #   ##. . #  ##    @   #
 #####...##$##  ##$ $ $ #
     #...  #    #   $   #
     #.######$#### $ $ ##
     #.#    $  ##   $ ###
     #.   $  $  $  $  #
     #.        ##  ##
     ######  #   $ #
          #### ##  #
             #   ##
             #####