  #####
  #   ##########
  #            #
  #.#########  #
  # $ $     #$ #
### #  $  #    #
#   #   #  #   #
# @  .......   #
################