#############################
#                           #
# .$.$.$.$.$.$.$.$.$.$.$.$. #
# $.$.$.$.$.$.$.$.$.$.$.$.$ #
#.$.$.$.$.$.$.$.$.$.$.$.$.  #
# $.$.$.$.$.$.$.$.$.$.$.$.$ #
#.$.$.$.$.$.$.$.$.$.$.$.$.  #
# $.$.$.$.$.$.$.$.$.$.$.$.$ #
#.$.$.$.$.$.$.$.$.$.$.$.$.  #
# $.$.$.$.$.$.$.$.$.$.$.$.$ #
#.$.$.$.$.$.$.$.$.$.$.$.$.  #
# $.#                       #
#  # ####  ####  ####  ###$##
#  # #  #  #  # @#   # @#$$ #
#  # #  #  #  #  ###  ##$$  #
#  # ####  ####     #   $$  #
#                           #
# .$.$.$.$.$.$