                  #######
          ######## #     #
  #########     ## #   $ #
  #      . #   ### # $$$ ##
  #  .      $##.#    $  # ##
  # #. # #  # # ### $$  #  #
  #      #  #  ...#   $  ##
  ## # ## $  $ # ### $  $ #
 ##  .  #  ##    #   $ $  #
 #  #   #  ## ## # $  $ ###
 # ## ######  #  #   $  ##
 #       #      ##  $ $ #
 #  ###  #  # #  #### $ #
 # ##.# ##  #  ##    $ #
 #  # .    $#   # $$ $ #
 ##  # #### ##@ #   $ #
  #  .        #'#####  #
  #     #######      ##
  ########    #######
          ########