  #########
  ##       ####
  # .$ $ $ $ #
###.##.#.##.###
# $ # $ #$ # #
#  . . . .  # #
##    # # ##  #
 #### @ ####
  #### 