           #########
           ###    ####
           #  # ..$###
           #     . $ ##
           ##$# $ # $ #
          # $  # ##$  #
          #  $$ $   $ #
         ## @#   $ $  #
         ##   #########
        ##
       ##
      ##
     ##
    ##
   ##
  ##
 ##
 #