 #######
 #  #  #
##  .  ##
# .$$. #
#. $ $.#
## $@$
 # .$. #
 ## .  ##
 #  #  #
 #######