          ####
          #  #
    #######$ ##
    #  $ $ $  #
    # ##$.$## #
    #  $ $ $  #
    ## ##.## ##
   #  $ $ $  #
 ####$## # ## ####
 #  $ $ # $ $ $  #
 # ##.## ##$## ###
 #  $ $ $  $  $ #
 ## ##.##$## ## #
 #  $  $ $ $ $  #
### ##$## .$.$ ##
#  $ $ $  # $#  #
#  ##$#######    #
##   #  #@       #
 ####   #  #######