            #####
           ##   ###
        #### $ $ $ ##
     ###  #  #..#   #
    ##   $   #..#$  #
  ### $##  $ ###    #
  #   #  $  #      ##
 ## $  ######  ##  #
 #  $$ # @#     ####
 #      # #  #  ##
 ## ###  ####   #
  #..#      $  $###
  #..#     $  $   ##
  #..#  ###  $ $ $ ##
  #  #### ##   ###
  ###    # #####