  #####
  #   ###########
  # $ $ $ $ $ $ #
### ##. . . . ##. ####
#  . . . . . . . .  ##
# . .############ . ##
## .  #      ##   . #
## .  #      ##  .  #
 # .  ###  ###  .  ##
 # .    ####    .  #
 ## .  ##    #  . ##
 ## .  ##    # . ##
  ## .  ###  # . ##
  ## .    #### ##
   ## .  ##    #
   ## .  ##    #
    ## .  ##  ##
    ## .   ####
     ## .   ##
     ## . ####
      ##    ##
      ##    #
       ##  ##
       ##  #
        ## ##
        ## #
         @  #
         ####