          ###########
          ###########
          ###########
          ###########
#####################
#####################
##################  #
################  $ #
################    #
######  #  # $ # $  #
#####   . ..   #  ###
#####  .  ..     $@#
#####   .  ..   #  ###
#######   # $ # $  #
##########     #  #
########### $  #  #
##########  #  #  #
################  #
################## #
####################
          ###########
          ###########
          ###########
          ###########