 #################
 #  #  #  #  #  #  #
##  #### #### ###  #
#     #   #  #          #
#  #  #. . . #  #  #
###  ##    #   ###  #
  #  #. . . .# #  #
##   #   ##     ##  #
#  #  #. . . #  #  #
#   ##   #    ###  #
###  #  @  #  #  #
#  #  #   ##   ###  #
# . ##. . . # #  #
#  ##   #  ##  #
#          #   #     #
## ### #### ####  #
 #  #  #  #  #  #  #