              #######
              #  #  #
      #########.#.. #
     ##         . $ #
     # $$ $ $ $ $ #$#
##### #  .#. . .    #
#   ###.#. ##########
#      .  .  #
# $ $ $ $.$ ########
##$#    #.#
 #   #### #####
 #  ##          #######
 #######.########      #
       #.   @    .####$###
     ##.#####.   . #  $  #
  #### .      ####   #   #
  #  #. $$$$$        $$ $ #
 ##  #. # . #########.  # #
 #   #.   .     #   #.    #
 # $ # $$$$ $$$$   #.$$$$$#
 #  .    #        #.   #  #
 ##  #.  #########.# #.  ##
  ##  #.           .   #  #
   ##  #########.# #.#  $  #
    ## $  #   # .   . $ $  #
     ######   #     #     #
          ######  ####  ####
              #      #  #
              ###########