# ############ #
     #  #  #
 #  $ $ $ $  #
  ####. .####
### #   # ###
#  $.  .  .$ #
# #   # #   #$
# .  .$ $.  .#
### ####### ###
# .  .$ $.  .#
# $  # #   # #
#  $.$   $.  #
####. .@. .####
  #  $ $ $  #
 #  #  #  #
# ############ #