   #### ###     ####   ######
   #  ###@##    ##  #####    #
   #    # # #####  .#      # #
   # ## #   #   # $ #  ##  # #
   # ## ###   ##  # #  ## #  #
   #  #  ## ##   . .#  ## # ##
   ##  #  # ###$#$.##  ##  # #
  ### ## #  # #...# ####  # #
 ##  #  #  #  #.$.$@## #### #
 #   ## #### ##.....#       #
 #      #  #    #   #########
 ######   ######