          #####
     ######   ######
     #    #       #
   ### $  ####   ####
   # $ $  $        #
####  ###. ### ## # ###
#   .#   .   # #    $ #
#  ....... # # #  #  #
##  # $ ### #.  #### ##
 ###  $ @   .....  # #
   #        .   #   #
   ####   ### #### ####
      ######       #
      #      #     #
      ########   ##
             #####
