    #####
    #   ######
    #  $ $ $ ##
    ## . . .$ # ####
##### . . .  # #  #
#   ## . . .      #
#  $ ## . . . #####
# $ $ ##. .  #
#  $ @### $$  #####
##    #  ....#     #
###### #..........#
     # ##. . . . . #
     # ############