           #######
           #######
        ####      ##
        # $ $ $  # ###
      ### # ## # #   #
      #  ###   ### ...#
     #     $  $ # ...##
    ## # #$##   ##...#
  ###  ###   #   ##.##
  #. . $  $$ # $$   #
 ##...#   #  $  $   #
 # ...# #  $$ $  . ##
 #...   ### # ##   #
 ### # # ## #   ####
   #   #  # # ####
   ###    $ $ #
     ##  @   #######
      ###       ####
        #### ####