     #####
     #   #
  #### . ##
  #  $$.$ #
  #$# $ # ###
###    . $  #
# ..### ### #####
#.     $  ##    #
#  ###$#  ### #  #
# #  $      . #$ #
#  . #### @#####.#
###    #       $ #
  #### #  ## #  #
     #  #    #  #
     ########