       ######
       #   ##
       #   ##
      ##  $ ######
     ##     .  @ #
   ### $  $ . #####
   #   $ #  . #
  ## #  ## . $  ###
  #  .     . # $ ##
 ##.##   # $  #   #
 #...# $ #  .  # $#
 #...   #   $##  @#
 #...$$ ###  $. $ #
 #. .#    $  $ $  #
 #.      #### ##  #
 ##.  ####   $  ###
 ## ###  # $$ $  ##
 #  #.   #    # $ #
 # $ #.  ## $ #   #
 # @  #### .  $  ##
 ###### $  $  $  ##
      ##      #  ##
       ##     ####
        #######