        ####
 ########  ####
 #      ####  #
 #.###  #  #  #
 #.# $  .  #######
 #  ## $  @  #   #
###    $  #  $  3#
#   #  #####  ####
#...    ######  #
#####  ##   #   #
    ####    ## ###
    #   $  #    #
    #  $  ###  $####
    #  #####     #
    # ##   #.#   #
    # #  $.....$ #
    #  $$$#.#   ##
    ##    #.# $ #
   ##  ####.  $ #
   #  ##  ##### #
  ##  ##      # #
  #  ###  #### .#
 ## ##  ###  #. #
 #  #      ##.  #
 #  ######    ###
 #  #    ##.  $ #
## ##  #.  ####  #
#  #  #.  $ #   $#
# @#  #. $  #  # #
####  ##  ########
   ####