           #######
 ###########  #   #
 #      #  #   # . #
 #   #  #  #  ## # #
 ##  ##  ##  # .  #
  #  ####  ## # # #######
###   ##  ##  # # #  ...#
# $   ## $  $  # # #   ..#
#  # $### $  $ # # # $$..#
#     # # $  $ # # #    .#
#..#### # $  $ # # ####..#
#...     #  #     #     .#
#..####  # @ #  # # ####..#
#...#  # #   # # # #  #...#
#   #  #  #  # # # #  # $ #
# #  #  #  ## # # # ##   $#
#  #   ##  ##  # #  ##   $#
# ####  ####  #   #  #####
#  .#
##. #######
 #  #
 #. #
 # # ##
 #  ## #######
 #    #       #
 # .   #  # # #
 ## #  #  # $ #
  #  #  #  #   #
 ##  #  #  # # #
 #   # $  #   $.#
 # . # $$# $$$.#
 # .   $  $    #
 #   ##########