  #####
###   ###
#  .$.  #
#   #   #
## # # ##
 # $ $ #
## # # ##
 #  $  #
## # # ##
 #  .  #
## # # ##
 #  @  #
 #######