 #######
##     # #
#   #   #
#  $  # #
#  # $ #
#  .$.#
## .$.  #
###$@$ ##
  # .$.#
  # $  #
  # #  $#
  # # $ #
  #   #  #
  #######