#############################
#  #   #   #   #   #   #   #  #
#  #  $#$  #  $#$  #  $#$  #  #
#  #  .$   #  .$   #  .$   #  #
#  #   #   #   #   #   #   #  #
#  ##  #  ##  #  ##  #  ##  #  #
#    $ $ $ $ $ $ $ $ $ $    #
#  ##  #  ##  #  ##  #  ##  #  #
#    $ $ $ $ $ $ $ $ $ $    #
#  ##  #  ##  #  ##  #  ##  #  #
#  #   #   #   #   #   #   #  #
#  #  $#$  #  $#$  #  $#$  #  #
#  #  .$   #  .$   #  .$   #  #
#  #   #   #   #   #   #   #  #
#  ##  #  ##  #  ##  #  ##  #  #
#    $ $ $ $ $ $ $ $ $ $    #
#  ##  #  ##  #  ##  #  ##  #  #
#    $ $ $ $ $ $ $ $ $ $    #
#  ##  #  ##  #  ##  #  ##  #  #
#  #   #   #   #   #   #   #  #
#  #  $#$  #  $#$  #  $#$  #  #
#  #  .$   #  .$   #  .$   #  #
#  #   #   #   #   #   #   #  #
#  ##  #  ##  #  ##  #  ##  #  #
# @  $ $ $ $ $ $ $ $ $ $  #
#  ##  #  ##  #  ##  #  ##  #  #
#  #   #   #   #   #   #   #  #
#  #  $#$  #  $#$  #  $#$  #  #
#  #  .$   #  .$   #  .$   #  #
#  #   #   #   #   #   #   #  #
#  ##  #  ##  #  ##  #  ##  #  #
#    $ $ $ $ $ $ $ $ $ $    #
#  ##  #  ##  #  ##  #  ##  #  #
#    $ $ $ $ $ $ $ $ $ $    #
#  ##  #  ##  #  ##  #  ##  #  #
#  #   #   #   #   #   #   #  #
#  #  $#$  #  $#$  #  $#$  #  #
#  #  .$   #  .$   #  .$   #  #
#  #   #   #   #   #   #   #  #
#  ##  #  ##  #  ##  #  ##  #  #
#    $ $ $ $ $ $ $ $ $ $    #
#  ##  #  ##  #  ##  #  ##  #  #
#    $ $ $ $ $ $ $ $ $ $    #
#  ##  #  ##  #  ##  #  ##  #  #
#  #   #   #   #   #   #   #  #
#  #  $#$  #  $#$  #  $#$  #  #
#  #  .$   #  .$   #  .$   #  #
#  #   #   #   #   #   #   #  #
#  ##  #  ##  #  ##  #  ##  #  #
#    $ $ $ $ $ $ $ $ $ $    #
#  ##  #  ##  #  ##  #  ##  #  #
#    $ $ $ $ $ $ $ $ $ $