 #####
##   #####
#  $ $   ####
# $   $  $ ##
### ### $   #
  #     $ $ #
  #   ### ###
  ### ##    #
    #  $  $ ####
    # $ $   #  ###
    #   # $ #    #
    ## $ #.  #  . #
    #  $ #. ..$  #
    # .$@#. # $  #
    #  .#.$  # ###
    #. ..# $ ##
    #  . #   #
    ###  $ $ #
      # $ $ #
      ####   #
         # $ #
         #   ##
         #####
            #