  ###################
  #  #  #  #  #  #  #
  #     #     #     #
  ### ### ### ### ###
   #     # # #     #
#### #### # #### ####
#  $  #  # # #  #  $  #
#.#.$ #     #     $.#.#
#  $  #  # # #  #  $  #
#### #### # #### ####
   #     # # #     #
  ### ### ### ### ###
  #     #     #     #
  #  #  #  #  #  #  #
  ###################