    ######
    ##   #
    # . #  ####
    #  $   #  #
    ###$##$.$ #
#####   $ #.  ####
#   ## $  . #$   #
#  $    # #   $  #
# # ###  $  # # ##
# # #  $ # ## # #
# # # # #  $  $ #
# # # # #$##   $#
# # # #  .  $ ##.#
# #   #  ####   @#
#  ###        ####
# $  ##########
#  $   ####
# $  # ##
#  # #  #
#   $   #
#####@####
    ######