  ####
###  ###
# .$$. #
# $  $ #
#.$.@$.#
# $  $ #
# .$$. #
###  ###
  ####