    #######
    ##   ###
    #  #   ##
    # $  $ ##
    ###.#.###
     # $ $ #
     ##.$$.#
    ##  @  #
    # .$$.##
    # $ $ #
    ###.#.###
    ## $ $ #
    #  $ $ #
    ##   #  #
    ###   # #
    ####   ##
      ######