#############################
# ##  #  # # #  # #  #  #  ##
#    #  # # # #  # #  #  #  #
##  #  #  # # #  # #  #  #  #
#    #  # # # #  # #  #  #  #
#  # #  #  # # #  # #  #  #  #
#  # #  # # # #  # #  #  #  #
#  # #  #  # # #  # #  #  #  #
#  # #  # # # #  # #  #  #  #
#  # #  #  # # #  # #  #  #  #
#  # #  # # # #  # #  #  #  #
#  # #  #  # # #  # #  #  #  #
#  # #  # # # #  # #  #  #  #
#  # #  #  # # #  # #  #  #  #
#  # #  # # # #  # #  #  #  #
#  # #  #  # # #  # #  #  #  #
#  # #  # # # #  # #  #  #  #
#  # #  #  # # #  # #  #  #  #
#  # #  # # # #  # #  #  #  #
#  # #  #  # # #  # #  #  #  #
#  # #  # # # #  # #  #  #  #
#  # #  #  # # #  # #  #  #  #
#  # #  # # # #  # #  #  #  #
#  # #  #  # # #  # #