  #########################
  #  #  #  #  #  #  #  #  #
  # #   #   #   #   #   # #
  #  #  #  #  #  #  #  #  #
  # #   #   #   #   #   # #
  #  #  #  #  #  #  #  #  #
  #   #   #   #   #   #   #
  #  #  #  #  #  #  #  #  #
  #   #   #   #   #   #   #
  #  #  #  #  #  #  #  #  #
  # #   #   #   #   #   # #
  #  #  #  #  #  #  #  #  #
  #   #   #   #   #   #   #
  #  #  #  #  #  #  #  #  #
  # #   #   #   #   #   # #
  #  #  #  #  #  #  #  #  #
  #   #   #   #   #   #   #
  #  #  #  #  #  #  #  # 