    #####
    #   #
    #   ####
  ### ##  #
  #   $   #
  #  $.$  #
  ## $.$###
 ## $.$  #
 #  $.$  #
 #   $  ##
 #  ## ###
 ####   #
    #   #
    #####