   #####
  ##   #
  #  $ #
  #  $ ####
  ##$  #  #
   # $    #
   #  $####
   ## #   #
####  $   #
#  # $  $ #
#    ##   #
#  #####  #
####   ####
   ######
   #   ##
   #     #
   #  $  #
   ## # ##
  ##  $.$#
  #  $@$ #
  #  $  ##
  ####   #
     #   #
   ####  #
   #  #  #
   # $   #
   #  $  #
  ## $ ###
  #     #
  #  $  #
  #  $ ##
  #### #
    #  #
    #  #
    ####