    #####
    #   ###
    #  $  ##
    # $.$  #
    ## $.$ #
   ##  .$  #
  ##  $.$ ##
  #  $...$#
  # .$...$#
###$.$.$.$###
#   ...   #
# $.$.$.$ #
#  .....  #
###########
   @
   #####
   #   ###
   #  $  ##
   # $.$  #
   ## $.$ #
  ##  .$  #
 ##  $.$ ##
 #  $...$#
 # .$...$#
###$.$.$.$###
#   ...   #
# $.$.$.$ #
#  .....  #
###########
