      #####
      #   ####
      #  $   #
      #  #   #
      ## # # #   ####
     ### . . ### #  ####
     # ..# # #   ##$   #
     # ..# # #$$## $   #
     # ..  . .  #  # $  #
     # ..# # #  #  # $ ##
     # ..# # #### ##  $ #
     # ..  #    .    #  #
     ##.###### ####  ####
      # #   $  .  #  #
      # #   $ ### ####
      # ####  #  # ##
      #     . .  # #
      # #  # # #$ ..#
     ## #  # # #$ ..#
     #   $ ##   . ..#
     #   $##$$ # .. #
     #   ## #  # .. #
     ####  #  # #  ..#
        #  #### ## ..#
        ####   #  .. #
                ####