  ####################
  # # # # # # # # # #
###  # # # # # #  ###
#      # # # # #      #
#  ###  # # # #  ###  #
# #  # # # # # # #  # #
# #    . . . . .    # #
# .# # . . . . . # # .#
#    . . . . . . .    #
#. # . . . . . . . # .#
#    . . . . . . .    #
# .# # . . . . . # # .#
# #    . . . . .    # #
# #  # # # # # # #  # #
#  ###  # # # #  ###  #
#      # # # # #      #
###  # # # # # #  ###
  # # # # # # # # # #
  ####################