###############################
#  . . . . . . . . . . . . .  #
# .$.$.$.$.$.$.$.$.$.$.$.$.$ #
#  . . . . . . . . . . . . .  #
# .$.$.$.$.$.$.$.$.$.$.$.$.$ #
#  . . . . . . . . . . . . .  #
# .$.$.$.$.$.$.$.$.$.$.$.$.$ #
#  . . . . . . . . . . . . .  #
# .$.$.$.$.$.$.$.$.$.$.$.$.$ #
#  . . . . . . . .