      ####   ####
     ##  #####  ##
    ##   ##  #   ##
   ##    #   #    ##
  ##  # # # # # #  ##
 ##  $ . . . . $  # ##
 ## # $ $ $ $ $ $ # ##
##  . . . .@. . . .  ##
## # $ $ $ $ $ $ # ##
 ## # $ $ $ $ $ # ##
 ##  $ . . . . $  ##
  ##  # # # # #  ##
   ##    #   #    ##
    ##   ##  #   ##
     ##  #####  ##
      ####   ####