        ######
        #    #
        # ## ####
        #  #### @#
        ## # $ $ #
       ##  #  $  #
 ####### $ $ #  #
 #   ##  $  # ####
 #      $ $ # #    ####
 #  ####  # # # ## #  #
 # ##  #### # #    #  #
 # #  ##    # #### # ##
 # # #  # ####  ##   ##
 # # # $  $  #     ###
 # # #  $@$  #    ## ####
 # # ######  #   ##  #  #
 # #        ## ## #  #  #
 # ##########    #  ##  #
 #                ######
 ######