    #####
    #   #
    #   #####
  ### ##   #
  #   $ $  #
  #  #.#   #
  ## $.$  ##
 ##  #.# ##
 #  $ $.$ #
 #.#   #  #
##  .# #  #
# $@.$ $ ##
#  #   #.#
## # .  $#
 #  $ $  ##
 #   # ## #
 #####   #
     #   #
   ##### #  ####
   #  $  #  ##.#
   # #   # $$ #
   #  $  #  #.##
   ##  #####  #
   #   # ##   #
   #.##  #    #
   # $ $ #    #
   #. ## ######