    #####
    ##  ####
    #      ###
    #  $  $  ##
    #######   #
#####    ##$  #
##  #  $  $   #
# $ #######   #
#     . . . . #
## $  . . . . #
 #######   $  #
       #  ####
       ####
       #