      ####
      #  #
     ##  ###
##### #    # ####
#   ### ##    $ #
# $  . # #  #   ########
#  ##. . . $ ## #     @##
# $# . # # ##   # ## #  #
#  # ## $  #  # . .  $  #
###   ## #### .## ## # #
  # #    $   ## .  .  # #
  # #### ##  #   ## #####
  #  $  . . ## $ #     #
  ##   . #  # .  #  $  #
   #   # ##. ## $ #  ##
   ####    #   ## # #
      ##### ####   #
          #      ###
          #      #
          ###### #