           #######
           ##   ##
           #     #
           #     #
         ###     ###
         #         #
         #         #
       ####       ####
       #           #
       #           #
     ###     #     ###
     #       #       #
     #    $  #  $    #
   ###  .# # # # #.  ###
   #    ...........    #
   #  .#. . . . . .#.  #
 ###.................###
 #  .#. . . . . . .#.  #
 #    .............    #
##  .#. . . . . . .#.  ##
#    .................  #
#  .#. . . . . . . .#.  #
##  .# . . .@. . . .#  ##
 #  .#. . . . . . .#.  #
 #    .............    #
###  .#. . . . . .#.  ###
  #.................#
  #  . . . . . . .  #
  ###           ###
    #           #
    #           #
    #           #
    #           #
    #           #
    #           #
    #           #
    #           #
    #           #
    #############