       #######
       #     #
       # ### ####
       # # # #  #
       # # $   $###
       ## $ #.#.$ #
      ##.....@..$ #
      # $ #.#.#.$##
      #  $   $ # #
      # ### #### #
      #  #  # $ # #
     ## #### ### ##
     # $  $  $  $ #
     # # ####### #
     # # #  #  #  #
    ## $   $ #   $#
    #  ## ### ## ##
    # $  $ $  $  $ #
    #  #     #     #
    ####### #######