   #######  
 ###     #  
##   $ $ #  
#   #.#  #  
#  $.$. $#  
# #.#.#$#  
#  $.$. #  
# #.#.# ##  
#  $.$. $ #  
## #.#.#  #  
 # $.$. $ #  
 # #.#.# ##  
 #  $.$. $ #  
 ### #.#. #  
   # $.$. #  
   # #.# ##  
   #  $.$ #  
   ## #.# #  
    # $.$ #  
    ## # ##  
    #  $  #  
    # # #  
    #  $  #  
    ## # ##  
    # $.$ #  
    # #.# ##  
    #  $.$ $ #  
    ## #.#.#  #  
     # $.$ $ #  
     # #.#.# ##  
     # $.$. $ #  
     ## #.# #  
     # $.$ $ #  
     # #.# #  
     # $ $   #  
     ###     #  
       #######  