    #######
    #     #
    # ### #######
    # # . . . . #
    # #  # # # .#
    ##$# # # # ##
   ## $  $  $  ##
   # $# # # # $##
   #  # # # #  #
   ## ### ### ##
   #  # # # #  #
   # $# # # # $##
   #  $  $  $  #
   ## # # # # ##
   ## # . # # ##
   # . . . #  #
   ####### #####
       # #
  ###### ####
  ##  # # # #####
  ##    $ $ $ . ####
  #  ####### # .  #
  # ## $ $ $ ##. ##
  # #  # # #  #   #
  #    . . .    @ #
  ###### #### #####
       # #
       ###