     ######
     #    #
     #    #
     # ## #   ####
     # ## #####  #
  #####  # #  #  #
  #   #$ $   $   #
  # #$$ # # #  # #
  #  $  ...# $$  #
  ## # ##.$ $ # ##
 ## $  $ . #  $  ##
 #  # ##.$@$$.##  #
 # $   $ . #  $   #
 ## # ##.$ $ # ##
  #  $  ...# $$  #
  # #$$ # # #  # #
  #   #$ $   $   #
  #####  #  #  # #
     # ## #####  #
     # ## #   ####
     #    #
     #    #
     ######