  ###################
  #  #  #  #  #  #  #
### #  #  #  #  #  ###
#  ### #  ### #  ### #
# $  $ #  #  #  $  $ #
# .#. # # . # # .#. #
# $  $ #  ###  $  $  #
#  ### #  #  ###  ### #
# $  $ #  #  #  $  $ #
# .#. # # . #  .#. #
# $  $ #  ###  $  $ #
#  ### #  #  ###  ### #
# $  $ #  #  #  $  $ #
#  #  @  #  #  @  #  #
###  #  #  #  #  #  ###
  #  #  #  #  #  #  #
  ###################