     #######
     #     #
  #####. .###
  #   .$.   #
  #  $.$.$  #
  ####.@.####
  #  $.$.$  #
  #   .$.   #
  #####. .###
  #   # #   #
  ##$     $##
   #   #   #
   #### ####