           #####
           #   #
           #   ###
         ###     #
     ##### $  $   #
     #   # $#$ #####
     #    $ $  #
  #### ### ##$ #######
  #      $  ###       #
  #   #$##$         # ##
#### ##    #  #######  #
#  $ # ### ####      $ #
# $  @  . $     #####  #
#####.   # ####       ##
    # #### #    #######
    #      #
    ########