     #####
  ####   #
###      #
#   .$. ##
#  $.$   #
## .$.$  #
 #$.$ $  #
 # $.$   ##
 ## .$.$@#
 #   $.$##
 #  $.$ #
 ##.$.$.#
  #   # ##
  #      #
  #   ####
  #####