     #####
     #   #
  ##### ####
  ## $    #
### $ #   # ####
##  $ # # #    ####
#  $  #.# #  $  $  #
# $   #.# #.$  $ $ #
#  $  #.# #  $  $  #
##  $ # # #    ####
### $ #   # ####
  ##    @  #
  ##### ####
     #   #
     #####