   ####
   #  #
  ###$##
  #  $ #
  # $ .#
### .$.##
#  $... #
# $.$.$##
##...$  #
 #.$ $  #
 #. $ ###
 ##.$ #
 # $  #
 #  @ #
 ######