###############################
#  #  #  #  #  #  #  #  #  #  #
## ## ## ## ## ## ## ## ## ## #
#  #  #  #  #  #  #  #  #  #  #
 ## ## ## ## ## ## ## ## ## ##
#  #  #  #  #  #  #  #  #  #  #
 ## ## ## ## ## ## ## ## ## ##
#  #  #  #  #  #  #  #  #  #  #
 ## ## ## ## ## ## ## ## ## ##
#                             #
## ## ## ## ## ## ## ## ## ##
#  #  #  #  #  #  #  #  #  #  #
 ## ## ## ## ## ## ## ## ## ##
#  #  #  #  #  #  #  #  #  #  #
 ## ## ## ## ## ## ## ## ## ##
#  #  #  #  #  #  #  #  #  #  #
## ## ## ## ## ## ## ## ## ## #
#  #  #  #  #  #  #  #  #  #  #
###############################