  ####   ###    #####
 ##  ####  ##  ###   #
 #  @ $.# #  ## $ $ #
 # # ###$ $ # #  $  #
 #  $  #.## ## $ . ##
 # # $ # ##   $ ###  #
 #  $  $ # #  ##  ####
 ##   ##  # ###   ##
  #####   ###  ####