    ######
    ##   ####
    #  $    #
    #  $.$  #
    ###. .###
    #  $ $ #
  ### # # # ####
  #  $  # #    #
### ## .$.  #  #
#  $  . . #$  ##
# # # # # ## ###
#  $ $ $ #    #
#### .$. ## ###
   #  .  .  #
   ## $ $  #
   #  # # ###
   ####    #
      #    #
      ######