           ####
           #  #
         ###  #
         #    #
         # #  #
       ### ####
       #  # ##
       #    #
       # $# ####
     ###  #### #
     #  ## $  ##
     # #   $$   #
   ### ##$#  #  #
   #  $       $ #
   # #  #  # #$##
 ### ## #  . . #
 #  . . . # #. #
 # . # # #  .  #
 #### @ #### . #
     ###      ##
       #  #  ###
       ######