     #####
     #   #
     #   #
   ### ###
  ##     #
  #  $ $ ###
  # $ $.$ #
  #### .  #
   # $.$ ##
   # $ $ #
  ## ### ####
  #  $  $    #
 ## #.#.#.#  #
 #  $  $  $  #
 # # ### # ###
 #  $ @ $    #
 ####   #####