       ######        
     ###    #        
     #  # # #        
     # . . ###      
     ##$#.#          
    ## . .#          
    # $##$##         
    #  . . #         
    # #.#$##         
    #     # ##       
  #### @###  #       
  #      $   #       
  #   #  # # ##      
  #####   . . ##     
      ## . .  ##    
       ##$#.$##     
        # ###       
        # #         
        # ###       
        # #         
        # #         
        # #         
        # #         
        ###