    #######
    ##    #
    #  #  #
    # .$.#
    ###.##
#####  . #
#   $$$.#
#  @   .#
########