    #####
    #   #
    #   ####
  ### ##  #
  #  #   @#
  # # $ $###
  #  ##... #
  ##$.$ $ .#
 ## $.$ $###
 #  # ...##
 # # $ $  #
 #  $ $ # #
 ### $ #  #
   #  ## ###
   # #  $  #
   # ...# ##
   #  $ $  #
   ###...$ ##
    # $ $  #
    ## $ $ ##
    #  $ # #
    # ##  #
    #  ####
    ####