 ######
##    ##
#  ..  #
# $$$.#
# $.$.#
# $@$.#
# $$$.#
#  ..  #
##  ####
 ####