   ####
  ##  #
  # . ########
  #      #   #
  # .##     $.#
###.$  #  ##  #
#   ####  $   #
# $    $ ## . #
#.###  .  #   #
# @  #### $ ###
#   $    $    #
######## .##. #
      #   .  #
      # $.####
      #   #
      #####
