       ####
       #  #
       #  #
       #  ####
     ###     #
     #   $   #
     #  #.#  #
     # $.$. ##
   ### .@. ###
  ##  .$ $.#
  #  #.#.#  #
 ##  $   #  #
 #   ####   #
 ####   ####