  ####################
###  ..   ..   ..  ###
#   $  $ $  $ $  $   #
#  $ # $ # $ # $ #  #
# $  $  $  $  $  $ #
#  $ # $ # $ # $ #  #
# $  $  $  $  $  $ #
#  $ # $ # $ # $ #  #
# $  $  $  $  $  $ #
#  $ # $ # $ # $ #  #
# $  $  $  $  $  $ #
#  $ # $ # $ # $ #  #
# $  $  $  $  $  $ #
#  $ # $ # $ # $ #  #
# $  $  $  $  $  $ #
#  $ # $ # $ # $ #  #
# $  $  $  $  $  $ #
#   $ $ $  $ $  $   #
###  ..   ..   ..  ###
  ####################