            ####
            #  #
            #  #
            #  #
  ######### #  ########
  #       # #     #   #
  # ##### # ##### # # #
  # #   # # #   # # # #
  # # # # # # # # # # #
### # # # # # # # # # ####
#   # # # # # # # # #    #
# # # # # # # # # # # #  #
# # # # # # # # # # # #  #
# . # # # # # # # # # .  #
# $   $   $   $   $   $  #
# . # # # # # # # # # .  #
# # # # # # # # # # # # #
# # # # # # # # # # # # #
#    .    . @ .    .    .#
######### # # ###########
        # # #
        #   #
        #  ##
        ####