       ######      
       #    #      
       # ## #      
       #    #####  
       ## ##   ####
       #    $ $ $ # 
       ## ##$#$##$##
       #  $ $ $    #
       ##$#$## ## ##
       #    $      #
       # $  ####  ##
#####  #    #  #####
##  #####  ### ##  #
#      ##  #  $     #
# $      ##   #  $  #
#  ##  ##### ## ####
### ##  #   $ $    #
####  $ # $##$##$# #
   # ##$##$ $ $    #
####  $ $    #  ####
#  $ $ $    ##  # ##
# ##$#$## ##  $    #
#    $      #  #####
## ## ##$#$##$#$   #
#    $ $ $    #  $ #
# $##$#$## ##  ### #
#      $    #  ##   
## ####  $  #    #  
 #### #####  #####