#############################
#  #  #  #  #  #  #  #  #  #  #
# $  $  $  $  $  $  $  $  $  #
# $.$.$.$.$.$.$.$.$.$.$.$.$.$#
# $ $ $ $ $ $ $ $ $ $ $ $ $ $#
#.$.$.$.$.$.$.$.$.$.$.$.$.$.$#
# $ $ $ $ $ $ $ $ $ $ $ $ $ $#
# $.$.$.$.$.$.$.$.$.$.$.$.$.$#
# $ $ $ $ $ $ $ $ $ $ $ $ $ $#
#.$.$.$.$.$.$.$.$.$.$.$.$.$.$#
# $ $ $ $ $ $ $ $ $ $ $