     #######
######     #
#  ....$  ##
#  # ####  #
#  ###.##  #
## $ $ ##  #
 #  #.## $ ##
 # ##.###  #
 ## $ $  ####
 #  #  #   @#
 # ### ##  ##
 #     #####
 #######