     #####
  #####   #  ####
  #   ## $ #### @#
  #    ... #     #
  # $  .$$ # $  ##
 ##$$  ... $  ##
 #    # .$.$ $#
 #   ##$...  #
 #####   #   #
     #####  ##
         #  #
         ####