############################
# .    .   .   .   .   . $.#
#  .    .   .   .   .   .$ #    The player is represented by @
# .    .   .   .   .   . $.#
#  .    .   .   .   .   .$ #
# .    .   .   .   .   . $.#
#  .    .   .   .   .   .$ #
# .    .   .   .   .   . $.#
#@##########################