 ###       ###
 ##         ##
  #    #    #
 # $# ###  # $
#  $ #$#### $  #
#    # #  #    #
######@ . ######
  #   #...#
 #### .#. ####
 #   #...#   #
##$## .#. ##$##
 #   #...#   #
 #### .#. ####
  #   # #   #
 #  $ #### $# #
# $ # ### #$  #
 #  #    #    #
  #    #    #
 ##         ##
###       ###