      #####
 #####.....########
  #  ....# ....... #
  #  ....###.##.#.##
  ##  ....$$.##.#.##
  ### ##$#$$#.##.#.#
   #      $#  #.#. ##
   #       #  #.    #
   #########  #####@#
           ####  #  #
              ###   #
                #####