  #####
  #   #####
  #  $.$  #
### # # # # #####
#   . . . . .   #
# #$# # # # $#  #
#   . .@. . .#####
### # # # #   #
  #  $.$  #   #
  # #####   ###
  #     #   #
  #  ###   ###
  #### #####