           #########
           ####  #####
    #######  .  . $  ####
    ####  # $   ##$$   #
      #  $ #$$$#  $  ###
#####   # #.  # $  $  #
####  #   $  $ # ### ####
##  ##### $   .+......  #
##  ##  # # ### # #  #   #
##  ##    $ $ ##...  #####
##  ## ####### # #  $   ##
# $  $  $ #     # ## $   #
#  $   # # ...  # ## ### ####
###  $   . .#.###$  $  #   @#
  # ### ##.##    .  .  #     #
  # # # # ...########## ######
  #       # ##
  ######$ # ##
 ##  #   #####
 #   #
 ######