  #####
  #   #
  #   #       ####
### ####### ##  ####
###         ##     #
# $$$$.. ...## #   #
#     . . ...      #
# $   ... ...# #   #
### ####### ###+####
 ###+      @## $  #
  ##       ## $  ##
  #   ###  ## $  ##
  #    ##### $  ##
  #     #      ##
  #####   #   ##
      #####  ##