         ####
      #####  #
  #####  .#  ###
  #  .@.$ $.$ #
  #$ $.....$  #
  #  $ $#$ $  #
 ##  #. $ .  ##
 #  ##   $ ###
 #    ##### # 
 ######     # 