  ####
###  #####
#   @    #
#  $.$.$ #
#   . .  #
### . .###
  #$.$.$#
  #     #
  ### ####
### $.$ #
#   # # #
#   # # ###
##  # #  #
### # # ###
  ## # ##
   # # ###
   # #  ##
   #    #
   ######