   ####
   #  #
   #  #
   #  #####
  ##$.$  #
  # ..#$ #
  # $.$  #
### ##  ###
#      $ ##
#   # @  #
#########