  #####
  #   #
  #   #       ####
### ####### ##  ####
###$       ###     #
#  $  ...  #   #    #
#   #...#    # ######
##   ..#   ##$ ##
 ### ##   ### $$
  #  ######  $  #
 ##  #  $$  #   #
 #  @$$ $ ##### #
 #     #      # #
 #######..#  ##  #
  #     ... ##  ##
  #  ##...# ##   #
  ##    ..#   #  #
   ##   #    #   #
    ####   ##  ###
      #####  ###
        #   ###
        #   ###
        #####