   ####
   #  ####
  ##$.$ @##
###    . #
#   # .. #
#  #$... #
## $    ##
 #  #  ##
 #  ####
 ####