     #####
  #####   #
  #   .   ###
  #   B$$$.#
  #   B ##.####
  ##.  #  .#  #
   #.###  .  @#
   #  ## #.#####
   #    $$$B   #
   #  .   .    #
   ###   ####  #
   # #####  # ##
####   #  .# #
#   #   $$$  #
#   # $.#   ##
#####   #####
    ### #  #
    #  .   #
    #   ####
    ######