      #####
#######   #
#. @ $  $ #
#   ##$# ##
## ##.  $#
#   # .  #
#   ##.  #
#>    .  ##
#########