######  ####   #####
##  #####  #   #   #
##  ##  $  #   #   $#
##  ##    $  $ #    ##
##  #   $ # #  #   ##
##  # $  $   # ##  ##
##  #  $ # # . .# ##
##  # #   .  #. . #
##  #  $ # # ....#
##  # # $  #  ... #
##  #  $ $ # ....#
##  # #    #  ... #
##  #  $ $ # ....#
##  # # $  #  ...  #
##  #  $ # #   .##  #
##  # #   #  $  #   #
##  # .  # #   #   $#
##  #   . #  $ ##    ##
##  #   # # # $  $  ##
##  ##   #  #    $ ##
##  ##  #   #   $  ##
##  #####  # . @ ##
######  #### ###