     #####
  ####   #
  #  . # ###
  #$. #####
  #  . $ $ #####
  # $.$. @ #  ###
  #  $. $ $ $ . #
### .$.$.$# # # #
#.#   $ $  # # #
# ###. #  $ $ .#
# #### $.@.  # #
#   ### .$ #####
#####   ####
    #####