      #####
 ######   #
 #  $ $ ## ####
 #   $  #   # #
 #  $ $##$.  #
 # $ $  ' .  #
###    @  ****#
###########   #
        #   $ #
        #####  #
          #    #
          ##   #
           #  ##
           #  #
           #  #
           #  #
           #  #
           #  #
           #####