  #########
  ##  ##  #
### $$   ##
#  ...# ###
# $$.#   # #####
###    $         ##
  #. #. ###### #  #
  # $.$#    # ### #####
  ## .  .  . $ $  ...  #
   # $.$# # # ###.#.   #
   ###   $..$   ## ## ###
     #### #    #  $$  ##
       #  $  $  $    ###
     #### #    #  $$  #
     # $.$# # # ###.#.  #
     ## .  .  . $ $  . ##
      # $.$#    # ### $#
      ###    $         ##
    #### . # ###### #  #
    # $   # #     ### #####
#### #$      $  @  ##
#   .#$$$    #######
# ### ####  . #
##         ###
 ##  ##  #  ##
 #########