          #########
 ##########       #
 #   $    $   ...  #
 #      $  $  .##  #
 #   $    $   .#####
###  ####  ####
  ####  ####