#################
#               #
# .$ $ $ $ $ $. #
# $.$ $.$ $.$.$ #
# .$ $ $ $ $ $. #
# $.$ $.$ $.$.$ #
# .$ $ $ $ $ $. #
# $.$ $.$ $.$.$ #
#               #
# .$ $ $ $ $ $. #
# $.$ $.$ $.$.$ #
# .$ $ $ $ $ $. #
# $.$ $.$ $.$.$ #
# .$ $ $ $ $ $. #
# $.$ $.$ $.$.$ #
#               #
# .$ $ $ $ $    #
# @.$.$.$.$.

