 ###       ###
 ##         ##
  #    #    #
   #   #   #
    #  #  #
     # # #
      ###   ###
       #     #
     #### #####
    ##       $ #
  ###  $   #   #
 ##    # $ # $ ####
 #   #  $  #  $   #
 #   # $   +   # #
 #  #   $  #   $ #
 # #  $  # #  $  #
 ###   #   #   ###
   ##### $ #####
       #     ###
      ##### @ ##
      ###       #
      ###