                #####
                #   #
  ################ . #
  #   $ $ $ $ $    .##
  #   $ $ $ $ $ #  .#
  ## $# $ $ $ $ #  .#
 #  #   $ $ $ $      #####
 #  #   $ $ $ $ #  ####   #
##  # .$ $ $ $   ##      @#
#   ##. $ $ $ $ ##        #
#  #  . $ $ $ $          ##
#  #  . $ $ $ $ #  #######
#  #  . $ $ $ $ #  #
## #  . $ $ $ $.   #
 #  # $ $ $ $ $    #
 #  #   $ $ $      #
 ##### $ $ $ $ #  ##
     #  . $ $  #  #
     #      ##   #
     #   ####  ####
     #####  #  #
         #  #  ##
         #  #   #
         #  #   #
         #  #   #
         ####   #
           ##### #
             #   #
            #     #
           #    # #
          #    #  #
          ######  #
              #####