        ####
 #########  #
 # $ $ $ $ .#
 # ..#..#..###
### ## ## ## ###
#####   $ #####
#   #####   @ #
# $ $ $ $ #.  #
# ..........  #
### ###### #  #
  #   ##   #  #
 ##  #  ####  ##
##  ### $ ##   #
#  ## $ $ $  # ###
# #  $  ## #  #  ####
#  ###    # #  ###  #
# #  ##   # ### $ $ #
#  #  ### #     $   #
###  ##  #### # #.$ #
  #  ##  ##  #### ## #
 ## #  #  # $ $ $ $  #
##  ####  # $ .      #
#   @   # # $ ########
#  # ## # ### ##
# ##  ####  #   #
#  $   $ # #  ##
###$.$. # #  ##
  # $ $ # ####
  # . $ #
  #   # #
  ##### #