          ####
          #  #
          #  #
        ########
  #######    ###
  ## $ $ $ #  #####
  #   $    #  #   #
  #...#..$.    .@.#
### $ $ $ # # #   #
#   $         $    #
#  $  $  #   #  ####
#####  # #  $  $  $ ##
     #    $   #..#. #
     #####$  ##...  #
         ###    #.$ #
           ###### $ #
              ##    #
               ##   #
                #####
                #  #
              ###  #
              #  $ #
              #    #
              # $$$#
              #    #
              #  $ #
              ######