####
#  #####
#      #
# #  $ #
# # ##.###
#    .   #
#  $   $ #
### #  # #
  #   $  #
  ### # ##
   #@  $ #
   ########