     #####
     #   #
  #### . ###
  #  #    ##
  # $  $   #
  ###.##$  #
   #....####
   # .  ##@#
####$##  . #
#       $  #
#   $  $ . #
### ##.####
  #   #
  #   #
  #####