           #####
          ##   ##
     ###### $ $ ######
     ##   # $ $ #   ##
###### $ $ $ # $ $ ######
##   # $   ###   # $   ##
## $ #####  @  ##### $ ##
##   # $   ###   # $   ##
###### $ $ $ # $ $ ######
     ##   # $ $ #   ##
     ###### $ $ ######
          ##   ##
          #####