     ####
######  ######
#  .  #  #   ##
# $.$.   $  . #
### # ### # ###
  #     # #
  ### ### #####
  #@      $   #
  ##  #      ##
  #### ### ####
  # . . .  #
  #$  $$$  #
  # . . .  #
  # $ $ $  #
  #.######.#
  #########