     #######
     #     ##
  ##### #  ##
 ##  # .# ##
 #  $  .#$#
 # $$$.. .#
###$  # ..#
#   $ # #####
#   ## $ $ $#
####  #    $ #
   ##  $$  $ #
    ##      $#
   ##  ####  #
   ## #    # ###
####     @  $  #
#   ### #####  #
#....# # $ $ ## 
# .##. .#..  #  
###  # #$ $  #  
  # $#. .$$  #  
  #.  $ #  ###  
  # $#  ####    
  #  ####       
  ##