       #######
       #     ######
       # ...$ $ $ #
#####  # #.....# ###
#   #### #  # #  # #
# $    # ##  ###   #
# $ #  #  ####  # $ #
#  $ ### #  ##  #   #
##$  # #.$ @ .  # $ #
 # $   #  ##  #.$  ##
 #  $$ # $ $   ## #
 ##   $#     ####  #
  ###### # #    ####
       #   #
       #$  ####
       # #  # #####
       # ##   $ $ #####
       #   ##$  $      #
       #....  ## $   # #
       #    # ###### # #
       ######        # #
                      # #
        ############  # #
        #          #####