#############################
##    #    #   #   #    #   ##
#  $  #  $   $ $ $ $  $ # $  #
#  #  #  # #  $   $  ### # # #
##         # $ $ $ #       ##
 #  # # # ##  $ $ $  ## # #  #
 #       $  $ $ $ $ $       #
 # # # #   $   #   $   # # #
#       # # .....#.....# $  #
# # # #   #..... @ .....# # #
#       # # .....#.....# $  #
 # # # #   $   #   $   # # #
 #       $  $ $ $ $ $       #
 # # # # ##  $ $ $  ## # # #
##       # # $ $ $ #       ##
#  # # #   $ $ $ $  ### # # #
#  #  #  # #  $   $  $    #  #
#  $  #  $       #    $ #  $ #
##    #    ##### #    #   ##
################# #    #####
              #  .  ####
############# # # #  #
##   #    #   .   .#  #
#  $ #  $ # $ # $ ######
# #  #####   ###
#  $ #  $ # $ ##
# # # # # #  ##
#  $ #  $ # $ #
## # # # # # ##
 #  $ #  $  # #
 ##    #    ##
 ############