   ####
   #  #
   #  #
   #  ####
  ##$$.##
  #  @ ##
  # .$ ##
####.   #
# $.$. #
#  ##$###
####  # #
   ##   #
   ##  ####
    ## # #
    #  # #
    #    #
    ####  #
      ####