                #####
                #   #
  ################   #
  #    $ $ $ $ $     #
  #    $ $ $ $ $ .#####
  #     $ $ $ $  .#
  #  $ $ $ $ $    .#
  #  $ $ $ $      .#
### $ $ $ $        #
# $ $ $ $ $   ######
#  $ $ $ $   ####
#    +         #
#              #
#   ########    #
#####      #####
          ###