  #####
  #   #
  #   #
### ####
#  $$$ #
#  $.  ###
#  $$$.@#
#    ####
##  ##
###  #  ####
  #  ####  #
 ### $ $ $ #
 #  #..... #
 #    #####