          ########
########  #  @   #
#      #    # #  #
# ######  #    # #
# $ $ $ # # #       ####
#   .   # . #########  ####
#  ...    . .........   $ #
# # # # #  # # # # #    $ #
#.........            #####
  ##       ############
  ############