       ####
 #######  #
 #  ..$ $ #
 #  #.###@#
##  $. $  #
#  $ $ .. #
# ##.###  #
#  ##   ###
##### #  #
   #   ###
   #####