    #####
    #   ######
    #  $ $ $ #
##### . . .  #####
#   #  $  $  #   #
# @          #   #
##########   #####