###################################
##   #           #   #         #  #
## # # $ ### ### ## # #### # ## # ##
##  $  ### ### ###  $ #### # ## $  #
###$ ###. . . . . . ###  ## #  ##$##
##  $  # .#####.#####.#  #  # $  ##
# $ $ ###. . # . . . ##$ ### #  ##
#  $  #  ## # ##### .  $  ##   ##
## $ ###. . # .   ######$## # ####
##  $ # ##### #  ##       # #    #
###$ ## .   . #### $### ### # # # #
##  $ # #.#.###  ## # # ###  # # # #
# $ $  #   . #  #  $  #  ##  # #    #
#  $  ### # # ## $ ### ## #  #### ##
## $  # #. . . ##   #     #  #      #
##  $ # #####  # ### ### ##### #####
###$ ## .   . # ##   .   ##    #    #
##  $ # #.#.###  ## # #  ## ### # ###
# $ $  #   . #  #  $  #  ##   #   #  #
#  $  ### # # ## $ ### ## #  # # #  #
## $  # #. . . ##  $  #  #   ##   ####
##  $ # #####  # ##$ ### ###  ######  #
###$ ## .   . # ###$  #   #####    # $#
##  $ # #.#.###   # $ #  #   @   # #  #
# $ $  #   . # ##  $  #  ##   ## # ####
#  $  ### # # ## $ ### ## #  #  # #  #
## $  # #. . . ##  $  #  #   ## #   #
##  $ #  #####$# ##$ ### ## #  ######
###$ ## .   . ## #   .   ##         #
##  $ # #.#.###  ## # ####  ####### #
# $ $  #   . #  #  $  #    ##      # #
#  $  ### #$ # ## $ ### ## #  ####  #
###################################