################################
##    #             #     #    ##
#  $$ # $ $ $ $ $ $ $ #$  $#  $$ #
# $  $ # $  $  #  $  $ #  $  $  $#
#  $$ # $ $ $ $ $ $ $ $ # $$  $$ #
##    #             #     #     #
# $  $  $  $  $  $  $  $  $  $  $ #
#  $$  $  $  $  #  $  $  $  $  $$ #
##    #     #    #     #     #   #
 ##   #     #    #     #     #   ##
#  $$  $  $  $  #  $  $  $  $  $$ #
# $  $  $  $  $  #  $  $  $  $  $ #
#  $$  $  $  $  #  $  $  $  $  $$ #
##    #     #    #     #     #   #
# $  $  $  $  $  #  $  $  $  $  $ #
#  $$  $  $  $  #  $  $  $  $  $$ #
##    #     #    #     #     #   #
 ##   #     #    #     #     #  ##
#  $$  $  $  $  #  $  $  $  $  $$ #
# $  $  $  $  $  #  $  $  $  $  $#
#  $$  $  $  $  #  $  $  $  $  $$#
##    #     #    #     #     #  @#
################################