###########
#    #    ##
# #   $  # #
#  $ # #  # #####
##  # ..$ $ $  .#
 ##   # #  #    #
  ##$# $  .. #  #
  #      # $#$ ##
 ##     ##$  .. #
 #  #####  # #  #
 #  #   #  $ $ ##
 #      # $  # #
 #     ##@   # #
 #####  # $  ##   #####
##   #  $  ## #  ##   #
#  $ # # #    #  # $  #
# #  $    #### ##  #  #
#. $..  ##   ###   ##  #
#    #  #####   #####  #
# #  # $ $  #   #    # #
# ## $$$$  #   $   #   #
# .  #     #  ### ### ##
###########  ##     # #
            ##     ###