  #############
  #           #
###$#$#$#$#$#$###
#  .#.#.#.#.#.#  #
# $.$.$.$.$.$.$ #
#  .#.#.#.#.#.#  #
# $.$.$.$.$.$.$ #
#  .#.#.#.#.#.#  #
# $.$.$@$.$.$.$ #
#  .#.#.#.#.#.#  #
# $.$.$.$.$.$.$ #
#  .#.#.#.#.#.#  #
###$#$#$#$#$#$###
  #           #
  #############