             #####
             #   #
             #   ######
      #########     $  #
      # $ $         # ##
      #     # $ $ $ #
    ### ### ##      #   #####
    #   # #  #####    ####  #
#####$.  #             #    #
#   # ###    ####       #   #
#     ##      # #########
#    ##     ###......#
## $###     # .......#
 #    $     ###......#
 #  $ #     # .......#
 # $  ##### #  ####  #
 ###    #   #    #####
   #    #   #
   ######  @#
       #####