###############################
#.      .    .    .    .      .#
# ##  #  #  #  #  #  #  #  ##  #
# ##  #  #  #  #  #  #  #  ##  #
#  $  # $   # $  $ # $  $ #  $  #
# $  . $  . . $  . . $  . . $  .#
#  $  # $   # $  $ # $  $ #  $  #
#.   @.    . .    . .    .   @. #
#  $  # $   # $  $ # $  $ #  $  #
# $  . $  . . $  . . $  . . $  .#
#  $  # $   # $  $ # $  $ #  $  #
#.      .    .    .    .      .#
# ##  #  #  #  #  #  #  #  ##  #
# ##  #  #  #  #  #  #  #  ##  #
#  $  # $   # $  $ # $  $ #  $  #
#    .    . .   .  .   . .    @.#
###############################