  #####
  #   #
  #   #       ####
### ######### #  ####
#   ........  #     #
# #.######.## #  #  #
# #.# ++ #.#   #  # ##
#      +  +  #  #   #
##+#.# ++ #.# ##  ##
#  #.#  ##.#  #  ##
#   #  +  #    ##
########  #####
       ####
       #
       #
       #
       #
       #
       #
       #
       #
       #
       #
       #
       #
       #