     ####### 
   ###     ##
#### .  $$  #
#    . $  $ #
#  # #.## $ #
# #  ..#  $ #
#  # #.## $ #
# $  .    $ #
#    $.$  $ #
#  ### #### #
### @     ###
 ##     #####
 #  $$  .   #
 # $  ##.# ##
 # $##.#..  #
 # $##.#. # #
 #  $  .    #
 # $  $    ##
 # #  $.$  #
 # $  .    #
 #  $$  .  #
 ####     ##
   #######