  ####
  #  ########
  #    $ $  ####
  #  #$#  $ $ ####
  #  # .# $ $ $  #     ####
  ###    # ### ####### #  ####
   ##   .  # ###       #    @ #
   #  # ....$ ## $######## #  #
   #      . #####        ##   #
   # # #.   ## ####  #  #  #####
   #  ##. # ####  #### ####
   #  # ### ####       #
####    ###    #     ###
#   $ $ $ $    #
#  $#  $ $ #  ###
#  $  $  $#  ##
####  #$#  #  #
   ####  #  #
       ####  #
         #####
           ###