      ######
  ##### #   #####
  #   # #     # #
  #  $  #  $   # #
  ##$  $  # ##$  #
 ## $  $  #  $    #####
 #  $  $  # #   ###   #
 # $ $ ## # ##$      @#
 #  $  #  $  #   ###  #
###   #  $  $ ## #  $ #
#   $ # $ $  ##  # $  #
# #   #  $  $ #   #  $#
# #   ## # ##  $ ######
#  $  ##
# $ $##
#  $  ##
###   #  #   #  #   ##
  #  $ # #   #  #  $ #
  # $ $ $ $ $ $ # $  #
  ##   #     #    $ ##
   ##  #     #  $  ##
    #####   #######
       #####