 ##### #####
 #   ###   #
## $ $$ $  ##
#  $ # # $  #
# $  # #  $ #
#  $ # # $  #
##$  # #  $##
 #  $###$  #
##$     $  #
 # $$$@$$$ #
##$     $  #
 #  $###$  #
## $  #  $ ##
 # $ # # $ #
#  $ # # $  #
# $  # #  $ #
#  $ # # $  #
## $ $$ $  ##
 #   ###   #
 #####  #####