#############################
#     #  #  #  #  #  #  #    #
##$#$##$##$##$##$##$##$##$# #$
#  . ..  ..  ..  ..  ..  .  #.#
# .$# .$# .$# .$# .$# .$# .$  #
#  +  ..  ..  ..  ..  ..  .  #
# $#$##$##$##$##$##$##$##$#$##
#  . ..  ..  ..  ..  ..  .  .#
# .$# .$# .$# .$# .$# .$# .$# #
#  ..  ..  ..  ..  ..  ..  +  #
#$#$##$##$##$##$##$##$##$#$# #
#  . ..  ..  ..  ..  ..  .  .#
# .$# .$# .$# .$# .$# .$# .$  #
#  ..  ..  ..  ..  ..  ..  .#
##$#$##$##$##$##$##$##$##$# #
#    #  #  #  #  #  #  #     #
#  $  # #.$ # $  #  #  $  #$$#
#    .  .  .    .  .  .  .  + #
#############################