######
##  ##
## $#########
#  @ #  #  ##
# .  #$.#$.##
###   $. $. #
  #         #
  ###########