 #########
 ##    ###
 ## #$.$ #
## .$. #@#
#     .$ #
#  .$.#$##
## #     #
 #   #   #
 #########