      #
  #########
 ###  .   ##
 # $  @.$$##
 # $. #$.  #
 # .$ #    #
##. ## ## .##
 #    # $. #
 #  .$# .$ #
 ##$$.   $ #
 ##   .  ###
  #########
      #