          #
         # #
        # # #
       #     #
      #   $   #
     #  # $ #  #
    #   # # #   #
   #   .  .  .   #
  #  ##   #   ##  #
 #                 #
# # $$#.# @ #.#$$ # #
 #                 #
  #  ##   #   ##  #
   #   .  .  .   #
    #   # # #   #
     #  # $ #  #
      #   $   #
       #     #
        # # #
         # #
          #