          #########
          ####  ###
    #######  $ .  #
    ####  $ .     #
#####  $ .   ### $###
##  $ .   #### #   ##
##     ####    # . ##
# . ####   #   ## $##
#   #   # # # # #   #
##$ ##   #   #  # . #
## . #  # # # # ## $###
##   # #   #   # #   ##
###$ ## # # # #  # . ##
  # . #  #   #   ## $##
  #   # # # # #   #   #
  ##$ ##   #   #### . #
  ## . #    ####     ##
  ##   # ####   . $  ##
  ###$ ###   . $  #####
    #     . $  ####
    #  . $  #######
    ###@ ####
    #########