            ########
            ####   #
      #######  $ . #
      ####  $ .   ##
#######  $ .   #####
####  $ .   ########
# @$ .   ####
#     #######
#  ####
#######