       #####  #####
       #   #  #   #
       # #.####.# #
       # ..    .. #
#####  ### #### ###
#   #    # #    #
# # ##   # #@## #
#  $ ##  # #  # ###
##  $ ## # $  $.. #
 ##  $ ### #  #.# #
  ##  $ ## ## #   #
   ##  $ # #  #####
    ##  $  $ ##
     #####  ##
         ####