 #########
###  @  ###
#         #
# $ $.$ $ #
####. .####
  ##   ##
 ##     ##
 #       #
 #   $   #
 #   .   #
 #       #
 #   $   #
 #   .   #
 ##     ##
 ### . ###
   #   #
   #####