##################
#@ .    .     .  #
# .$  $ $  $ $ . #
#.   $.   $.   $.#
# $   .$   .$    #
#   $    $ .  $  #
# $...$... $ ..$ #
#  $    $  . $   #
#    $.   $.   $.#
#.$   .$   .$    #
#   $ .  $    $  #
# $.. $ ...$...$ #
#  $  . $    $   #
#    $.   $.   $ #
#.$   .$   .$   .#
# . $ $  $ $  $. #
#  .     .    .  #
##################