############## #######
#             #       #
#.##########  #$#####  #
#           #        #  #
# ########  # ######  #  #
#         #         #  #  #
# ######  # #######  #  #  #
#       #          #  #  #  #
# ####  # ########  #  #  #  #
#     #           #  #  #  # #
# ##  # #########  #  #  # # #
#   #            #  #  # # # #
#$  # ##########  #  # # # # #
# #             #  # # # # # #
# # ###########  # # # # # # #
#. @           $           . #
##############################