             ####
   ##### #####  ##
  ##   ###       ##
 ##       . $ # @ ##
 #  ##   ## ### #  #
 # ##    #  # $  # #
 # #    #  #     # #
## #   ## # # ###  #
#  ## # #. $ .##  ##
# #.# ## ## #.#  ##
# #  $  #. $ .$ ##
#   #   $.#  . ##
##### ## ## # ##
    # # $  #  #
    # #    # ##
    #  #$##  #
    ##      ##
     ########