          #####
         ##   ##
         #     ##
         #    @ #
############ #. #
#            #.##
# ############.#
#             .#
##$#$#$#$#$#$#.#
 #            .#
 ###############