                #####
  ###############   ########
 ## $ $ $ $ $    $ $ $ $ $ ##
###     #         #        ###
#  #.##.#.##.#.##.#.##.#.##  #
# $#  .$ $  $#  .$ $  $#  .$ #
#  .  #$  $ $.  #$  $ $.  #  #
# $##.#.##.#.##.#.##.#.##.#$ #
##      .  #   @  .  #      ##
##      #  .      #  .      ##
# $#.##.#.##.#.##.#.##.#.##$ #
#  #  .$ $  $#  .$ $  $#  .  #
# $.  #$  $ $.  #$  $ $.  #$ #
#  ##.#.##.#.##.#.##.#.##.#  #
###        #         #     ###
 ## $ $ $ $ $    $ $ $ $ $ ##
  ########   ###############
         #####