   #####
   #   #
 ### . ###
 ##     ##
 #   .   #
 #   $   #
 #       #
 ##     ##
  ##   ##
####. .####
# $ $.$ $ #
#         #
###  @  ###
 #########