 #####
 #   ##########
 #  $ $ $ $ $ #
### #.#.#.#.#.###
#     # #   #   #
# # #.#.#.#.#.# #
# # $ $ $ $ $ # #
#  #  # # # # # #
##  ###   #   # #
###    ### ###  #
######    @    ##
     ###########