####
#  #
# @#####
#   $  #
#   .  #
### ####
  #   ##
  #$#. #
### #$ #
# . #. #
#    $ #
#  ##  #
#  #####
####