 ####
 #  ###
 # $  ###
 #  . $ ###
### # ..$ #######
#   . # . $ #   #
# # $ .$#$. $ # #
#   # $ . # .   #
####### $.. #@###
      ### $ .  #
        ###  $ #
          ###  #
            ####