 ####
 #  #
 #@ #
 #  ####
### ## #
#      #
#  $   #
#####. #
 # ## ###
 #      #
 #   $  #
 # .#####
### ## #
#      #
#  $   #
#####. #
 # ## ###
 #      #
 #   $  #
 # .#####
 ####