    #####
    #  ##
    #  ##
    #$ ##
##### .######
#####    $  #
#   . @ .   #
#  $    #####
######. #####
    ## $#
    ##  #
    ##  #
    #####