     #######
     #  @  #
###### ### ######
#   #   $   #   #
#   $   #   $   #
##$### ### ###$##
#   $   #   $   #
#   #       #   #
##$### ### ###$##
#   #   $   #   #
# .. ...#... .. #
###### ### ######
     #     #
     #######