 #####
 # @ #
## # ###
# .#$###
#      #
#      #
# .#$###
## # ###
 #   #
 #####