   #############
   #     #     #
   # $ $ $ $ $ #
   ### ##### ###
####.$   $   $.####
# ...# $ # $ #... #
#  $## #.#.# ##$  #
##   . . @ . .   ##
#  $## #.#.# ##$  #
# ...# $ # $ #... #
####.$   $   $.####
   ### ##### ###
   # $ $ $ $ $ #
   #     #     #
   #############