     #######
#### #     #
#  ### $$$ #
#  ....$  #####
#  ..# $  #  @#
###$##$#### # ######
 #. ....$  $  ###  #####
 # ..#####  ##   $ $   #
 #.... .... #  $$  # $ #
 ########## #$$ ## #   #
    # $.###        $  ##
    #       $###$# #  #
    #####   $    $ ####
        ####    ####
           ######