           ######
    ####  ##    #
  ###  #  #  ## ###
###    #### #   $ #
#  $ @ ... ..  $  #
# $ $  ## ###   ###
### ###   # #####
 #      ###
 #   ####
 #####