        #
       # #
      # . #
     #  $  #
    #   .   #
   #   .$.   #
  #   .$ $.   #
 #   .$ $ $.   #
# .$.$ $@$ $.$. #
 #   .$ $ $.   #
  #   .$ $.   #
   #   .$.   #
    #   .   #
     #  $  #
      # . #
       # #
        #