###       ###
#############
### . . . ###
 # .$   $. #
 # $$$ $$$ #
 # .$   $. #
### . + . ###
#############
###       ###