         #### ####
         #  ###  #
      #### $ $   #######
      #   $   #$   ##  ####
      # ### ###        #  #
     ##  $   ###### #     #
     #  $ # ##    #####   #
     # # #  #  # $$ # ## ###
     # #    #$.## $        #
     # ######   $  # ###   ##
     #.... .  .# #   # #   ##
     ####      # ##### #####
       ##$## ###$#
      ##  #   $  #
#######   # $    #############
# $      ###### ##         @ #
#        .........           #
##############################