       #########
       ###    ##  ####
#####  #      ##  #  #
#   ####       ####$.##
# .$       @       $. #
##.$####       ####   #
 #  #  ##      #  #####
 ####  ##    ###
       #########