 ### # #### ##### #### # ###
############# @ #############
##  .     .   #     .$.    ##
## .$.$$$.$. ###.$  $.$  $.##
 #.$$$. .$$$.# #$.       .$#
## .$.$$$.$. ###.$  $.$  $.##
#   .     .   #     .$.     #
# ######################### #
#   $.   .$   #  $       .  #
##    .$.    ### .       $ ##
 #  $.$ $.$  # #           #
##    .$.    ### $       . ##
 #  $.   .$   #  .       $ #
############# # #############
##            #            ##
##$.$  .$.$.$.#  .  $$$ .  ##
##.$.$.$.$.$.$#  $. ..$.$  ##
 #$.$.$.$.$.$.#  $.$.. .$  #
##.$.$.$.  $.$#  . $$$  .  ##
#             #             #
# ######################### #
#    ..  ..   # . $ .$ . $  #
## $ $ $$$$ $ #  . .$.$ $  ##
 #  . .. .$.$ #$.$.$  .$.$.#
## $.$. .. .  #.$.$.  $.$.$##
## $ $$$$ $ $ #  $ $.$. .  ##
##   ..  ..   # $ . $. $ . ##
############# # #############
 #   .   .    #      .     #
## $$ $$$ $$ ### .$ $$$.$. ##
 #..... .....# # $.$... .$ #
## $$ $$$ $$ ### .$.$$$ $. ##
#    .   .    #      .      #
# ######################### #
#   .  .  .   #   . . . .   #
## $$  $$  $ ### $.$.$.$.$ ##
 #. .     . .# # $$$   $$$ #
## $  $$  $$ ### $.$.$.$.$ ##
##  .  .  .   #   . . . .  ##
#############   #############
 ### # #### ##### #### # ###