#############################
#.      .   .   .   .      .#
# ##  # # # # # # # # #  ## #
# ##  $ # $ # $ # $ # $  ## #
#  ##$$$#$$$#$$$#$$$#$$$##  #
#   $...$...$...$...$...$   #
# #$$.#.$.#.$.#.$.#.$.#.$$# #
#   $...$...$. .$...$...$   #
#.###$$$#$$$#$$$#$$$#$$$###.#
#   $...$. .$. .$. .$...$   #
# #$$.#.$.#.$.#.$.#.$.#.$$# #
#   $...$. .$. .$. .$...$   #
#.###$$$#$$$#$@$#$$$#$$$###.#
#   $...$. .$. .$. .$...$   #
# #$$.#.$.#.$.#.$.#.$.#.$$# #
#   $...$. .$. .$. .$...$   #
#.###$$$#$$$#$$$#$$$#$$$###.#
#   $...$...$. .$...$...$   #
# #$$.#.$.#.$.#.$.#.$.#.$$# #
#   $...$...$...$...$...$   #
#  ##$$$#$$$#$$$#$$$#$$$##  #
# ##  $ # $ # $ # $ # $  ## #
# ##  # # # # # # # # #  ## #
#.      .   .   .   .      .#
#############################