         ##### # #####
        ## # ##### # ##
        #  #   #   #  #
       ## $  $   $  $ ##
       #   .. # # ..   #
       ### ..  #  .. ###
        # $  $ # $  $ #
  ##### #   # .$. #   #
 ## # #### ###$ $### ###
 #  #   #   # .$. #   #
## $  $   $  $ # $  $ #
#   .. # # ..  #  .. ###
### ..  #  .. # # ..  @#
 # $  $ # $  $   $  $ ##
 #   # .$. #   #   #  #
### ###$ $### #### # ##
 #   # .$. #   # #####
 # $  $ # $  $ #
### ..  #  .. ###
#   .. # # ..   #
## $  $   $  $ ##
 #  #   #   #  #
 ## # ##### # ##
  ##### # #####