              ####
           #### .#
     ####  #    .####
   ###  ####  ##..  ##
   #  $ #  #$ #...   #
   # #  #  #  #...   #
   # #$ # $ $ #      #
####  $    #  #    @##
#     # #$$#####   ##
#   $ $ #  #   #####
######  #  #
     ####  #
        ####