###########
#         #
# $## ### ##   #####
#  # $ $ $ #####   ###
# $    #     # $. .  #
#  ##$###$## # #...# #
# $    #     # #. .# ##
## # $ $ $## # #...#  #
#  ## ### #. # #. . # #
# $       #    #    # #
# @######## ###     # #
####     #       ###  #
         # ####  #   ##
         #     ##  ###
         #####    ##
             ######