  #####
 ##  ###
###.   #
#   @$ #
#    ###
#  ###
# $$ # #
# .. #
## $#####
#    #  ##
# .  #$.##
###   $. #
 ##      #
  ########