#####       #####
#@  #########   #
# #  ######## # #
#  # $ $.$ $    #
##    .. .. # ###
 ##$ # $#$ # $##
 ## . . # . . ##
 ##$.$ ### $.$##
 ##. ####### .##
 ##$.$ ### $.$##
 ## . . # . . ##
 ##$ # $#$ # $##
### # .. .. # ###
#    $ $.$ $    #
# # ######### # #
#   #########   #
#####       #####