#########################
###   ##    ##    ###   #
##.$. ##.$. ##.$. ##.$. #
# $.$## $.$ # $.$## $.$##
# .$. # .$.## .$.## .$.##
# $.$ # $.$ # $.$ # $.$ #
##    ##    ##    ##    #
#### ####  ### #  ##  ###
#### ##### ### ##### ####
   #                 #
## #########@######### ##
   #                 #
#### ##### ### ##### ####
#### ####  ### #  ##  ###
##    ##    ##    ##    #
# $.$ # $.$ # $.$ # $.$ #
# .$. # .$.## .$.## .$.##
# $.$## $.$ # $.$## $.$##
##.$. ##.$. ##.$. ##.$. #
###   ##    ##    ###   #
#########################