    ####
    #  ######
    #  $ $  ###    ####
    #   $     #   ##  #
##### # #$$$  #  ## $ #
#     $ $   $ # ##    #
#  #$    $ $##### $$ ##
## # ####  .....#   ##
#      # $    .## ###
#   #  # $$ #.##.   #
##     #    #.#+  # #
 #     ######.##..$ #
 ####### # $..##.####
         # #  .. .#
         #   .#.  #
         ######$# #
              #   #
              #####