###################################
##  #######   #########       #####
##  $ $ ### # ########  ###    #  #
## # .. ### $.   # $.$  ### #$.   #
#  .   #### .$   #  . . ###  .$   #
# $$..$$ ### #$. ### . $$ ### #$. #
###   .  #  .$   ## . .   ## .$   #
## .. # ## #$.   ##$. $.#### $.   #
#  $ $  ##    #  # $ #$ #### # ## #
# ####  ##   ### #      ####   ## #
# #####    ##### @ ############## #
# ##################      ###     #
# ##  #  #####  #  # # $$ $ $ $$ ##
#      $ $ #   $ $   ### .# #. ####
## # .$.   # # .$. # ### ..  . ####
## ##.. ## # #$...$# ####.# #.#####
##   .$. # # # .$. # ### .  .. ####
## $   $   #    $    ### .# #. ####
####  #  #####  #  ### $$ $ $ $$ ##
########       #######    ###    ##
###################################