   #########
   #       #
#### $ $$$ #
#   $#$# # #
#. .. ..$. #
##$#.#..#  #
##   #... ##
###$ @ $  ##
  # $ $ ####
  ##  ###
  #######