    #####
   ##   ######
   #  @   #  #
   #  #  $   #
####  ###$#. #
#.....#    .##
#.....# #$#. ###
###     . ##   #
 #  ## ##$ ### ####
 #   #  #  $  $   #
 #   $$$# #  $  $ #
 #####  # ######  #
     #$    #   ####
    ## $ # #
    # $    #
    #    ###
    ######