     ####
######  #
##      #
#  .$.$ #
#      @#
#  .$.$ #
##      #
 ##  #  #
  #######