     ####
######..#
#     . #
#  #  ..#
#  ## ###
#    $  ##
#  # #$ @#
#  # $ $ #
#  ## $ ##
#####   #
    #####