    ####
#####  ##########
#      #  #     #
# #  ..   ##   $###
# # ##.#.  # $$$@ #
#      #.  # $  # #
#   ######## $  # #
###    $       ## #
  #.############  #
  #.             ##
  ################