#########################
#  #  #  #  #  #  #  #  #
# $#$ # $#$ # $#$ # $#$ #
#  #  #  #  #  #  #  #  #
## # ### # ### # ### # ##
#  #  #  #  #  #  #  #  #
#     #     #     #     #
# ### # ### # ### # ### #
#  #  #  #  #  #  #  #  #
#  #     #  $  #     #  #
#  # ### # ### # ### #  #
#  . . .  . + .  . . .  #
#########################