    #######
    #     #
    #     #
##### ### #
#       .#
#  $  # .#
## $  # @#
 #  $ ## #
 # #  $  #
 # #  $ ##
 # . #  #
 #.  #  #
 #.  #  #
 #.     #
 #     ##
 #######