    #####
    #   ####
  ### #   #
 ## $ $ $ #
 #  ## .  #
 # #  .# ##
 # ..# # #
 #  ## $ ##
### # $   #
#  $  #   #
#    @#####
######- #  
     #### 