    #####
    #   ####
  ### #   ###
 ## $ $ $  ##
 #  #.$. $  ##
 # # $.$. $ ##
 ##  #.$. $ ##
 ###  #. $$ ##
   ##  $.#  ##
  ### $$.#  #
 ##  #  .# # #
 #  $    .#  #
 #  $    ##  #
 #  $  #   # #
 #  ####   @ #
 #      #####
 #######