  ##########
 ##  #     #
 #   $.$   #
### $@$#   #
#  # $ #   ###
#  . $ #  #  #
##    $ ## # #
 ### .  ## # #
  #  #### ## #
  #########  #
           ## 
            #