                              #####
  #############################   #
 ##  ..........................#  #
 #  # .........................#  #
 # ## .........................#  #
 # # ######### ................## ##
 # #         ##################    #
 # #  #######.................#####    ####
#### ##     ##.................   #####  #
#    #       ##.................       #  #
# $  ##       ##...............         #  #
# $ $ ##       ##.............           #  #
#  $  ##       ##.............           #  #
# #   ##       ##.............           #  #
#  ## ##       ##.............           #  #
## ##  ##       ##............           #  #
## ##  ##       ##............           #  #
#  ##  ##       ##............           #  #
#  ##  ##       ##............           #  #
#  ##  ##       ##............           #  #
#  ##  ##       ##............           #  #
#  ##  ##       ##.............           # #
#  ##  ##       ##..............          ##
#  ##  ##       ##...............        ##
#  ##  ##       ##................      ##
#  ##  ##       ##.................    ##
#  ##  ##       ##.................. ##
#  ##  ##       ##.................. #
#  ##  ##       ##.................. #
#  ##  ##       ##.................. #
#  ##  ##       ##.................. #
#  ##  ##       ##.................. #
#  ##  ##       ##.................. #
#  ##  ##       ##.................. #
#  ##  ##       ##.................. #
#  ##  ##       ##.................. #
#  ##  ##       ##.................. #
#  ##  ##       ##.................. #
#  ##  ##       ##.................$ #
#  ##  ##       ##.................$ #
#  ##  ##       ##.................$ #
#  ##  ##       ##................$  #
#  ##  ##       ##.................  #
#  ##  ##       ##.................  #
#  ##  ##       ##.................  #
#  ##  ##       ##.................  #
#  ##  ##       ##.................  #
#  ##  ##       ##.................  #
#  ##  ##       ##.................  #
#  ##  ##       ##.................  #
#  ##  ##       ##.................  #
#  ##  ##       ##.................  #
#  ##  ##       ##.................  #
#  ##  ##       ##.................  #
#  ##  ##       ##.................  #
#  ##  ##       ##.................  #
#  ##  ##       ##.................  #
#  ##  ##       ##.................  #
#  ##  ##       ##.................  #
#  ##  ##       ##.................  #
#  ##  ##       ##.................  #
#  ##  ##       ##.................  #
#  ##  ##       ##.................  #
#  ##  ##       ##.................  #
#  ##  ##       ##.................  #
#  ##  ##       ##.................  #
#  ##  ##       ##.................  #
#  ##  ##       ##.................  #
#  ##  ##       ##.................  #
#  ##  ##       ##.................  #
#  ##  ##       ##.................  #
#  ##  ##       ##.................  #
#  ##  ##       ##.................  #
#  ##  ##       ##.................  #
#  ##  ##       ##.................  #
#  ##  ##       ##.................  #
#  ##  ##       ##.................  #
#  ##  ##       ##.................  #
#  ##  ##       ##.................  #
#  ##  ##       ##.................  #
#  ##  ##       ##.................  #
#  ##  ##       ##.................  #
#  ##  ##       ##.................  #
#  ##  ##       ##.................  #
#  ##  ##       ##.................  #
#  ##  ##       ##.................  #
#  ##  ##       ##.................  #
#  ##  ##       ##.................  #
#  ##  ##       ##.................  #
## ##  ##       ##.................  #
## ##  ##       ##.................  #
#  ##  ##       ##.................  #
#  ##  ##       ##.................  #
#  ##  ##       ##.................  #
#  ##  ##       ##.................  #
#  ##  ##       ##.................  #
#  ##  ##       ##.................  #
#  ##  ##       ##.................  #
#  ##  ##       ##.................  #
#  ##  ##       ##.................  #
#  ##  ##       ##.................  #
#  ##  ##       ##.................  #
#  ##  ##       ##.................  #
#  ##  ##       ##.................  #
#  ##  ##       ##.................  #
#  ##  ##       ##.................  #
#  ##  ##       ##.................  #
## ##  ##       ##.................  #
## ##  ##       ##.................  #
#  ##  ##       ##.................  #
#  ##  ##       ##.................  #
#  ##  ##       ##.................  #
#  ##  ##       ##.................  #
#  ##  ##       ##.................  #
#  ##  ##       ##.................  #
#  ##  ##       ##.................  #
#  ##  ##       ##.................  #
#  ##  ##       ##.................  #
#  ##  ##       ##.................  #
#  ##  ##       ##.................  #
#  ##  ##       ##.................  #
#  ##  ##       ##.................  #
#  ##  ##       ##.................  #
#  ##  ##       ##.................  #
#  ##  ##       ##.................  #
#  ##  ##       ##.................  #
#  ##  ##       ##.................  #
#  ##  ##       ##.................  #
#  ##  ##       ##.................  #
#  ##  ##       ##.................  #
#  ##  ##       ##.................  #
#  ##  ##       ##.................  #
#  ##  ##       ##.................  #
#  ##  ##       ##.................  #
#  ##  ##       ##.................  #
#  ##  ##       ##.................  #
#  ##  ##       ##.................  #
#  ##  ##       ##.................  #
#  ##  ##       ##.................  #
#  ##  ##       ##.................  #
#  ##  ##       ##.................  #
#  ##  ##       ##.................  #
#  ##  ##       ##.................  #
#  ##  ##       ##.................  #
#  ##  ##       ##.................  #
#  ##  ##       ##.................  #
#  ##  ##       ##.................  #
#  ##  ##       ##.................  #
#  ##  ##       ##.................  #
#  ##  ##       ##.................  #
#  ##  ##       ##.................  #
#  ##  ##       ##.................  #
#  ##  ##       ##.................  #
#  ##  ##       ##.................  #
#  ##  ##       ##.................  #
#  ##  ##       ##.................  #
#  ##  ##       ##.................  #
#  ##  ##       ##.................  #
#  ##  ##       ##.................  #
#  ##  ##       ##.................  #
#  ##  ##       ##.................  #
#  ##  ##       ##.................  #
#  ##  ##       ##.................  #
#  ##  ##       ##.................  #
#  ##  ##       ##.................  #
#  ##  ##       ##.................  #
#  ##  ##       ##.................  #
#  ##  ##       ##.................  #
#  ##  ##       ##.................  #
#  ##  ##       ##.................  #
#  ##  ##       ##.................  #
#  ##  ##       ##.................  #
#  ##  ##       ##.................  #
#  ##  ##       ##.................  #
#  ##  ##       ##.................  #
#  ##  ##       ##.................  #
#  ##  ##       ##.................  #
#  ##  ##       ##.................  #
#  ##  ##       ##.................  #
#  ##  ##       ##.................  #
#  ##  ##       ##.................  #
#  ##  ##       ##.................  #
#  ##  ##       ##.................  #
#  ##  ##       ##.................  #
#  ##  ##       ##.................  #
#  ##  ##       ##.................  #
#  ##  ##       ##.................  #
#  ##  ##       ##.................  #
#  ##  ##       ##.................  #
#  ##  ##       ##.................  #
#  ##  ##       ##.................  #
#  ##  ##       ##.................  #
#  ##  ##       ##.................  #
#  ##  ##       ##.................  #
#  ##  ##       ##.................  #
#  ##  ##       ##.................  #
#  ##  ##       ##.................  #
#  ##  ##       ##.................  #
#  ##  ##       ##.................  #
#  ##  ##       ##.................  #
#  ##  ##       ##.................  #
#  ##  ##       ##.................  #
## ##  ##       ##.................  #
## ##  ##       ##.................  #
#  ##  ##       ##.................  #
#  ##  ##       ##.................  #
#  ##  ##       ##.................  #
#  ##  ##       ##.................  #
#  ##  ##       ##.................  #
#  ##  ##       ##.................  #
#  ##  ##       ##.................  #
#  ##  ##       ##.................  #
#  ##  ##       ##.................  #
#  ##  ##       ##.................  #
#  ##  ##       ##.................  #
#  ##  ##       ##.................  #
#  ##  ##       ##.................  #
#  ##  ##       ##.................  #
#  ##  ##       ##.................  #
#  ##  ##       ##.................  #
#  ##  ##       ##.................  #
#  ##  ##       ##.................  #
#  ##  ##       ##.................  #
#  ##  ##       ##.................  #
#  ##  ##       ##.................  #
#  ##  ##       ##.................  #
#  ##  ##       ##.................  #
#  ##  ##       ##.................  #
#  ##  ##       ##.................  #
#  ##  ##