                             
############# ###############
#           # #             #
# .$ $ $ $  # # .$. $ $ $ $  #
#  #  #  #  ## ##  #  #  #  ##
### ### ### # # ### ### ### #
### ### ### # # ### ### ### #
#           ######           #
# .$ $ $ $ $ $ $ $ $ $ $ $ $.#
#  #  #  #  #  #  #  #  #  #  #
## ### ### ### ### ### ### ##
## ### ### ### ### ### ### ##
#  #  #  #  #  #  #  #  #  #  #
# $.#. $ $ $ $ $ $ $ $ $ $ $.#
#  #  #  #  #  #  #  #  #  #  #
### ### ### ### ### ### ### ##
### ### ### ### ### ### ### ##
#           ######           #
# $ $ $ $  # # $ $ $ $ $ $ $.#
#  #  #  #  ##  #  #  #  #  ##
## ### ### ### ### ### ### ##
## ### ### ### ### ### ### ##
#  #  #  #  #  #  #  #  #  #  #
# $ $ $ $  #  # $ $ $ $ $ $ @#
#           # #             #
############# ###############