           #####
  ###########   ########
 ## $ $ $ $ $ $ $ $ $ $ $##
 # $ $ $ $ $ $ $ $ $ $ $ $ #
## $ $ $ $ $ $ $ $ $ $ $ $ ##
# $ $ $ $ $ $ $ $ $ $ $ $ $ #
# $ $ $ $ $ $ $ $ $ $ $ $ $  #
#  $ $ $ $ $ $ $ $ $ $ $ $ $ #
# $ $ $ $ $ $ $ $ $ $ $ $ $  #
# $ $ $ $ $ $ $ $ $ $ $ $ $  #
#  $ $ $ $ $ $ $ $