                 
############## ###########
#   #     #   ###   #     #
# $  $    #  $  #    #  $$ #
##  ##  ##### ##  #### ##  #
 ### ####   ######   #### ##
## #  #  $$  #   #  $$  #  ##
#  $  $    #  $$  #    $   #
#   #     #    #  $    #   #
#   #     #   ###  #     # @
#############################