    #####
    #   ##########
    #  $  $  $   ##
  ### #. #. #. #  #
 ##  ### ### ### ###
 # $  $  $  $  $ . #
 #  #. #. #. #. #  #
 ##  ### ### ### ##
  ###   # @  #   #
    ##  #####  ##
    ###########