#####                 #
#   ###########+###### #
#  ## $ $ $ $ # $    # #
# ##  $ #     #  #.#   #
# #   # #.###### $  #  #
# #  ## $     $ ##  #  #
# ######.# # # $ ###   #
#       #. $ #$  ##    #
########## $ @ #  #####+
         #. $ # $ $ $ ##
         ##+#$######.  #
          #  $ $ $ $## #
          # ######+#  # #
          #       #   # #
          #########   # #
                #########