 #####
 #   ###########
 #  $ $ $ $ $ . #
### #.#.#.#.### #
#   ...$ $ $ $ #
# #.###.#.#.#.###
# $ $ $ $ $ ... #
# ###.###.#.#.  #
#     $ $ $ @  #
#################