                     #####
  #####################   #
 ## $ $ $ $ $ $ $ $ $ ##  #
 # $ $ $ $ $ $ $ $ $ $ #  #
 # $ $ $ $ $ $ $ $ $ $ #  ##
 # $ $ $ $ $ $ $ $ $ $ #   #
 # $ $ $ $ $ $ $ $ $ $ #####          ######
 ## $ $ $ $ $ $ $ $ $ $ $ $###########    #
 ### $ $ $ $ $ $ $ $ $ $ $ $ $ $ $ $ $ $  ##
 #### $ $ $ $ $ $ $ $ $ $ $ $ $ $ $ $ $ $ #
 ###### $ $ $ $ $ $ $ $ $ $ $