                   
 ##### ##############  
 #   ###   #   #     #  
 #  $  #   ##$##  #  #  
 # $   #  # . #  #  #  
 ###$#### #  $ ######
   # . #  # $  #    
  ## #  # #  $ ##    
 ##  #  ######$###  
 #  #  #  . #  # #  
 #  ###### $  # $ #  
 #  #  .  #  # $ ##  
 #  #  #  # ##  #   
 ###### #### #  #    
       #   # ###     
       ##### #  
          #  @#  
          #   #  
          #####