###########
#    #    ##
# $  #  $  ##
##  $#$  $ #
 ## $@$#  #
 ##  $#$  #
 # $  # $ ##
 #    .   ##
 #    #    #
 ###########