  #######
 ##     ##
 # .$ $ .#
## $.$.$.##
# ..@... #
## $.$.$.##
 # .$ $ .#
 ##     ##
  #######

