##    ##### ##### #####   
#  ###   #   #   #   ###  
# ##  #  #   #   #  $  ## 
###  $ # #   ## ### $   # 
#  #$### #####  #  ##   # 
# #  $ ##         #  #  # 
# # #  ## $###    #  #  # 
# # #   # # . #####  #  # 
# #  #  # #.###  ##  #  # 
#  $  ### #### # @#  #  # 
#    ##  #  ###$  ## #  # 
#   ##   #    # $  ###  # 
#####    #    #  #  #####
###  #   #    #  #   $  #
##  #   ##    #  #  # . #
##  #  #.##### #  # ##$ #
##  ####. #  ###### ##  #
## ## $  #      ##   #  #
### $ $## #      #   #  #
#####   #####    #  ##  #
   #####    ######  #####