 #####                 #####
 #   ###################   #
 # # $ $ $ $ $ $ $ $ $ $ # #
 ##.#####################.#.##
 # $ $ $ $ $ $ $ $ $ $ $ $ $ #
 #.#########################.#
 # $ $ $ $ $ $ $ $ $ $ $ $ $ #
 ######### ######### #########
        # #       # #
        # #       # #
 ######### #       # #########
 #       # ##.#####.## #       #
 #       # $ $ $ $ $ $ #       #
 #       #.###########.#       #
 #        $ $ $ $ $ $ $        #
 #######.###########.##########
       # #         # #
 #######.#.#########.#.#######
 #      $ $ $ $ $ $ $ $ $     #
 #.#########################.#
 # $ $ $ $ $ $ $ $ $ $ $ $ $ $ #
 #.#########################.# 
 # $ $ $ $ $ $ $ $ $ $ $ $ $ #
 ######### ######### #########
 # @ #   # #       # #   # @ #
 #   #   # #       # #   #   #
 #####   ##       ##   #####
     #####         #####