 #####
 #   #########
 #     #     ##
## $ $  #     ##
#  $.$.$ #     #
## $ $ . #    ##
 #  $  ## ####
 #  .  ##
 #######
    #
    #####
    #   ########
    # @ #      #
    ##  #      ##
     #  #      ##
     ## #      #
      # #     ##
      # #######
      #     #
      #########
            #
            ####