      #####
      #   #########
      # $  $ $ $ $ #
      ## #. . . . # #
     # .... . .    #
   ####  . . .  ####
   #    . . .  #
   # #  . . .  #
   # #  . . .  #
   # ####. . . ##
   #. #### . . #
   #    ## . . #
   ## #  #  .  #
  #  .    #    #
  # #  ## # #  #
  #  #### @ ####
  #      ######