  #####
 ##   ###
 #  $ .@##
## #.$   #
#    . # #
#  ##. $ #
##  #.$  #
 ###   # #
  #######