#### $ $ $ $ $ $ $ $ $ $ $ $ $ $ $ #
#             . . . .            #
#   ###########     ###########  #
#  ##          # #  ##         ## #
# ##            . . ##           ##
##              # #  ##           #
##               @    #  #######  #
##              # #   ## #     #  #
# ##            . . ##  #       #  #
#  ##           # #  ## #       #  #
#   ##          . . ##  #       #  #
#    ##         # #  ## #       #  #
#     ##        . . ##  #       #  #
#      ##       # #  ## #       #  #
#       ##      $ $  ## #       #  #
#        ##         ## #       #  #
#         ###########  #       #  #
#                     $ $ $ $ $ @  #
####################################