##    ##### ############   #
#  ###   ###............#  #
# ## $    ## ...........#  #
###  $ #  ## ...........#  #
# ## $ #  ## ...........#  #
#  #  $ # ## ...........#  #
#  ## $ ###............#  #
#   ## $ ##............#  #
#    ##  ##............#  #
#    ###  ##############  #
# @                       #
######    #################
#....##########    ########
#....#       #######     ##
#....#              ####  #
#....#               ##### #
#....#                 #####
#....#                   ###
#....#                    ##
#....#                     #
#....#    ###################
#....#### ##   $  ##########
#.......# ### $   ##       #
#########  ##  $   #       ##
          ##   $  #        #
           #    $ #        #
           #    ##         #
           #     #         #
           #######         #
               #####       #
                  ##########