                     
##### ##### ##### ##### #
#   ###   #     #     # #
# #  $ $  # .$. # $ $   # #
#  # $ $  ###.###  $  $ # #
# #  $ $ $ $ $ $ $ $  #  #
#  #  $ $ $ $ $ $ $  # #  #
# #  #  $ $ $ $ $  #  # #  #
#  # #  $ $ $ $  # #  # #  #
# #  # #  $ $  # #  # #  # #
#  # #  # # # #  # #  # # #
# #  # #       # #  # #   #
#  # #  ####### #  # ######
# #  #          # #  #    #
#  # # ########## #  #    #
# #  #            # #     #
#  # # ############ #     #
# #  #              #      #
#   ## ##############      #
##### #               #######
      ###### ##########
           ###  #    #
            #   #    #
            #####    #