             
            #####
            #   ####
            # $  $ ####
          ###$ #$   ####
          #  $  $$ $  ####
          #       $ $  ####
          #         $  ####
        ###          $ ###
        #  @          $ #
        #              $ #
        ##################
       #. . . . . . . . . #
       # . . . . . . . . .#
       ####################