    #####
    #   ########
  ### #  ....  #
 ##   #### #####
 #  $ $   #
 # $ $  # ######
 ##  $  ###
  ## # ###
  #  #@#
  #    #
  ######