    #######
    #     ##
##### ###  ##
#       $$ ###
#  #  # $ $  #
##  ####.$. ##
 ##      .# ##
  #  #    # #
  ## ###### #
   #       @#
   ##########