            #####
            #   #########
            # # #       #
   ########### # #  ##### #######
   #.......... # ## #    ###     #########
   #..........   ## ####        ##       @##
  ##..........###       #########  #      ##
  # ..........          ##     ### ## #   ##
  # ..........#  ####    ##  #  ##   #  ## #
  # .........## #  ######### ## #### ##  ##
 ## ..........###       #   #### #  #### ##
 # ..............###### # ## $ $ ##    ###
 # ...........##     #### #  $$$  ## ####
 # ...........#  #  #  ##  # $ $ #   #
 # .......... ##  #  ##   ## $$$##   #
 ##......... #   ####     #  $  ######
  ##........ #########    ## #  #
   ##......##       ##    ####  #
    ##....## #       ##        ##
     ######  #        ###########
          #  #              ####
          ####               #  
            #                #
            ##################