#####                 #####
#   ###################   #
# # $ $ $ $ $ $ $ $ $ $ # #
# $ #     #     #     # $ #
##  #.###.#.###.#.###.#  ##
 #$ #  .  #     #  .  # $#
 #  .  #  .  #  .  #  .  #
 #$###.#.###.@.###.#.###$#
 #  .  #  .  #  .  #  .  #
 #$ #  .  #     #  .  # $#
##  #.###.#.###.#.###.#  ##
 # $ #     #     #  # $ #
 # # $ $ $ $ $ $ $ $ # # 
 #   ################### #
#####                 #####