                 
#####################
#   ########   #     ##
# $  ......#   # $$  ##
# $ $ ......## ##  # #
##    ......## ####$ #
### # ......#      $$#
# ## ######### # #   ##
#  ####      #### ##  #
#     # ## ###  #  #  #
#  #  #  #  ##  #### ##
#  #######       #   #
# ##     ######### ## #
##  ## #  ####  ## $  #
## $$ # #    #  ## $  #
# $$  ##  #  # #  $$  #
#  $ #  ##  ## #    ###
# $  ##  ##  ## # # ##
##    #  ##  #  #####
### #  #  ##  #   ####
# ### ##  #  ## # ## #
#    # ##  #  ##    @ #
#  # # ##  #  ## #    #
#####################