 #####
 #   ###########
 #  $ $ $ $ $  ##
### #.#.#.#.#.#.##
#  ##  #     #   #
#      @          #
#  ##  #     #   ##
## ###.#.#.#.#.#.#
# $  $ $ $ $  # ###
##  ###########   #
 ###     #  ##  #  #
   #     #     #  #
   ###########  ##
          #####