            #####
            #   #########
            # # #       #
   ########### # #  ##### #######
   #.......... # ##$    ###     #
   #.......... # ##     # $ $ $ #
   #.......... ## $  ## #  $ #  #
  ## ............ #$# #    ##$ ##
  #  ............ #  # #   ## $ #
 ##  ............ #    #  #  $  #
 #   ............ #     #    $ ##
 #   ............ #     # #  $  #
 #   ............ #     # #  $ ##
 #   ............ #     # #  $ #
 #   ............ #     # #  $ #
 #   ............ #     # #  $ #
 #   ............ #     # #  $ #
 ##  ............ #     # #  $ #
 #   ............ #     # #  $ #
 #   ............ #     # #  $ #
 #   ............ #     # # $$ #
 #   ............ #     # ##   #
 ##  ............ #     ####   #
 #   ............ #        #####
 #   ............ #
 #   ............ #
 ##  #########... #
 #           ######
 #              #####
 ###### #########   #
      # #     @ #   #
      ###     ###  ##
        #       #####