              #####
              #   #########
              # $  $ $ $ $ #
   ######     ##  ##        #
   #   #########  #  ###### ##
   # $  $ $ $  ######    # #
   ##  #        # $ $ $ $ # #
  ###  ##       ##  #     # #
  # ##  ##########  #     # ##
  # # $  $ $ $ $  ######  # #
  # #  ##        # $ $ #  # #
  # # ###       ##  #  #  # #
  # # # ######  ##   ##   # ##
  # # # #    ####    #####  #
  # # # # $ $ $ # $ $ $ $  $ #
  # # # #        #        ## 
  # # # ##       #       ##  
  # # #  #########  ######   
  # # # #      @  ##         
  # # # #       ###          
  #   # #########            
  #####                     
