####  #######
#  ###     #
#     $ .$ #
## ## #.# ##
##  $@$#  ##
###  #.#  ##
 #######  ##
        # ##
 #######  ##
 #. $ $   ##
 #. # #   #
 #     #  #
 #  ###  ##