  ######################
  # $  #    #  $# $     #
  #.$  #    #  #.$      #
  # $. ###### $. #  #####
  #  $.$    ##  @.$ $ $ #
  #     ######    #     #
  #######    #######    #
  # $  $###### $  $###### 
  ##.$.$.  ## .$.$  ##  
  #  $.#   ##  #.$   ##
  # $ #    ##  # $    ##
  ###  #    ##  #  #    #
    #  ######  ######  #
    # $  #  ###### $  #
    #  #.$  ##  #  #.$ #
    ##  . $##  ##  . $##
     ##    #  ##    #  
      ######  ######  