 #####
 #   ########
 #  $ $ $ $ #
### #.#.#.#.###
#   ...#..... #
#  ...#...... #
##  ..#.....  #
 ###..#....@ #
  #  #########
  ####
   #