  ######    ###########   
 ##   #    ##         #   
 #    #    #  $ $ $ $ #   
 #  . ## ###  #.#.#.#.#### 
## .     # ####       #  #
#  . # ##          ## #  #
#    # ###### ###### #   #
#  ####      # #    #### ##
####   # ##  ### ###    # #
  ###  #  ###########@  # #
    ####           ###### #
       ############      ##
                      #### 