    #########
    #  #    ##
  ### # $ $  #
  #   #$#    #
  # # .$. # ##
 ## ##.@. $ #
 #  # .$. $ #
 # ## #.$#  #
 ##    #  #  #
  #  ##    # #
  ##    #  # #
   #  ##  ## #
   # ##  #  ##
   #  ####   #
   ###########