          #####
          #   #########
          #  $  $  $ $ #
          ## #.##     ##
         #     #     ###
         #     #      ##
         #. ## # ###   #
 #######  #. ## #   ####
 # $ $ #####    #####  #
 # $   $ $ #     $ $ $  #
 #  #     #     #     ##
 #  ######     ######  #
 ##     # #####    #####
  ##    # #   $ $ $  $ ##
  ####   #  $  $  $  #  #
     ##### # $ $  #  # #
       #  ##     ## #. #
       ##     ##. #. ##
        ######.## #  #
           ##     #  #
           ##########