                 
#####################
#   ##   ##   ##   ##
#  $  $  $  $  $  $  #
# $  $  $  $  $  $  ##
#  $  $  $  $  $  $  #
##  $  $  $  $  $  $ #
#  .  .  .  .  .  .  #
# .  .  .  .  .  .  ##
#  .  .  .  .  .  .  #
##  .  .  .  .  .  . #
#  @  .  .  .  .  .  #
##    .  .  .  .  .  #
#     .  .  .  .  .  #
#      .  .  .  .  . #
#       .  .  .  .  .#
#        .  .  .  . @#
#####################