 #####
 #   ###########
 #  $ $ $ $ $ . #
### #.#.#.#.### #
#   # $ $ $ $   #
# @ #  $ $ $  # #
#   #   $ $  # #
######    $  # #
     ######  ##
          ####