                 
#############     ###########
# $  #      #######         #
#  $  ###.  #     #         .#
##$ $ $ #.  #     #          #
##  # #  .  #     #          #
# $  ###.  #     #########   #
# $ $#  .  #           @##   #
#  #  #.###            ##   #
##  ###.############   ##   #
###.  #       #  ##   #######
####   $      #  ########
#####  $      #
####   $      #
#  ##  #      #
#   ####      #
#     #########
#       ######
#  ####    . #
########   . #
       #####.#
       #  ##.##
       #    . #
       #    $  #
       #    $  #
       #      @#
       #########