                 
#############  ###########
#           #  #    #    ##
# .$ $ $ $  #  # .$. # .$. #
#  $ $ $ $  #  ##  ####  # #
###  # ##  #### # ##  #  ##
##  #   ####  ###    $ #$ #
### # #  @  #  #####  #  ##
##  ####   ##       ######
#####   ###         #    #
#### #  ###         # .$.#
#### # ###          # $ $##
#####  ##           # $. $##
##  #  ##           ##    #
##  ####             ######
#######               #####
###########  # #  #  #  ####
########### #   #    # ####
#############     #  ######
###############  #########