           #####
  ##########   #
  #    #     $ #
  # $  #  $ $  #
  #  ##$## .# ##
  ##  $ #  . $ #
 ## $  ##    $ #
 #  #  #####  ##
 # $# $    ####
 #  .  #####
 # #  #
 #  $ #
 # .  #
 ######