 #####
 #   ###########
## $  $ $ $ $ $ #
#  #.#.#.#.#.#.###
# # $ $ $ $ $  ##
### # # # # # $ #
  # ### ### #   #
 ##  # $ $ ### ##
 #  $ # @ #  ###
 # ### $ # # #
 #  $ $ $ $ #
 ## #########
 #  $  $  $  ##
 #.#.#.#.#.#.##
 # $ $ $ $ $  #
 ## ######### #
  #   # # # ### 
 ###  ## ##  #  
   ####     #  
      #######