    #####
    #   #########
    # $  $ $ $ $ #
  ### # #.#.#.#.# ####
 ##  ###       ####  #
 #      ## ###       #
 #   #$##  #  ######  #
 ##$# @ $ .        ###
 #   #$##  #  ######
 #      ## ###  #
 ##  ###       ##
  ### #.#.#.#.# #
    # $  $ $ $ $ #
    #########   #
          ##### #