  #######
 ##     #
 #  .$. #
## $ $ ##
#  . .  #
#  $$$@##
#      ##
#########