 #####                 #####
 #   ###################   #
 # # $ $ $ $ $ $ $ $ $ $ # #
 # $ #     #     #     # $ #
 ### #.###.#.###.#.###.# ###
 #   ##### ##### #####   #
 # # $ $ $ $ $ $ $ $ $ $ # #
 # @ #     #     #     #   #
 ####### #.###.#.###.##### #
       # ##### ##### #     #
 ####### $ $ $ $ $ $ # #   #
 #     # $ #     #   # $ # #
 # #   # . #     #     # @ #
 #   ###################   #
 #####                 #####