                 
#############  ###########
#           #  #         #
#  $ $ $ $  ##  ##  $ $  ##
# $ $ $ $  #      # $.$  #
##  $ $  ## #  # ##  $  ##
## $ $ $   ###  ### $$  ##
##  $ $ $ $  #  #  $$  ##
#  $ $ $ $  #  # $.$  ##
#   $ $ $ $ ## ##  $  ##
#  ##  $ $  ###  ### $$ #
# ##  $ $ $  #  #  $$  #
##  #  $ $ $  #  # $.$  #
##  # $ $ $  ## ##  $  #
##  ##  $ $  #      # $ #
#  ##  $ $ $  #  #  #  $$ #
#  #  $ $ $ $  #  # $.$  #
## #  $ $ $ $  ##  $  ##@#
#  ###########  ###########