#    ###########
#    #         #
#    #   ####  #
#    #   #  ####
#    #   # $ . #
#    #   # $ $ #
#    #   # . $ #
#    ##  # #####
##  ####  #
#  ##  ####
#  #    #
#  #    #
#  #    #
#  #    #
#  #    #
#  #    #
## #    #
#  #    #
#  #    #
#  #    #
#  #    #
#  #    #
#  #    #
#  #    #
#  ##   ##
#   #####
#      #
#########