      #####
     ##   #
    ## $  #
    #  $ ##
   ## #  #
  ##  #  #
 ##  $  #
 #  #$ ##
 ## $  #
  #  # ##
 ##  #  #
 #  $  ##
 ## $  #
  #  #  ##
 ## $  #
 #  #  ##
 ## $  #
  #  #  ##
 ## $  #
 #  #  ##
 ## $  #
 #  #  ##
 ## $  #
  #  #  ##
 ## $  #
 #  #  ##
  #######