    #####
    #   #
    #   #
  ###   #
  #  $  #
### $ $ #
#  #.$ #
#  #  ###
## #  #
 # $ $###
 # $ $  #
 # .#   #
 #  @   #
 #########