 #######
 #     #
 #     #
 # $ $ #
## # # ##
#   # #  #
#  $   $ #
# # # #  #
# # # #  #
# # # #  #
#  $   $ #
#   # #  #
## # # ##
 # $ $ #
 #     #
 #     #
 #######