#  ###########
#  #..  #    #
#  #.$  #    #
#  #.#  #### #
#  #.#     # #
####.###   # #
 #   @ ####  #
 #   #  ######
 #   #
 #####
     #
     #
     ######