 #####
#   #
#   #
#   #
# # #
#   #
#$.  #
# $$ #
#  $ #
#  . #
######
  #@# 
######
