 #######
 #     #
 ## ## ##
#  $ $  #
# # . # #
# # . . #
# #. . .#
# #  . .#
# # . . #
# # . # #
# # . . #
# # . . #
# # . . #
# # . . #
# # . . #
# # . . #
# # . . #
# # . . #
# # . . #
# # . . #
# # . . #
# # . . #
# # . . #
# # . . #
# # . . #
# @ $ $ #
 ## ## ##
 #     #
 #######