 #######
##     ##
# $@$ $ #
#  $.$  #
# $.$.$ #
#  $.$  #
# $.$.$ #
# $ $ $ #
##  .  ##
 ########