 #######  #######
 #     ####    #
 # $  $ $ $ $ #
 #  # $@$ $ $ #
### # $ $ $ $ #
#  # $ $ $ $  #
#  # $ $ $ $  #
#  # $ $ $ $  #
#  # $ $ $ $  #
#  # $ $ $ $  #
#  # $ $ $ $  #
#  # $ $ $ $  #
#  # $ $ $ $  #
#  # $ $ $ $  #
#  # $ $ $ $  #
## # $ $ $ $ ##
 # $ $ $ $ $ #
 #    ####    #
 #######  #######