 #######
##     ##
#  .$.  #
#  $.$  #
# $@$.$ #
#  $.$  #
#  .$.  #
##     ##
 #######