 #######
##     ##
#  .$.  #
# $.$.$ #
# .$.$. #
# $.$.$ #
#  .$.  #
##     ##
 #######
  #    #
  #   #
  #  #
  # #
  ##
  #
  #
  #
  #
  #
  #
  #
  #
  #
  #
  #
  #
  #
  #
  #