###########  #######
#    #    ####  #   #
#    #    #  ####   #
#    #    #  #  #   #
#    #    #  #  #   #
#    #    #  #  #   #
#    #    #  #  #   #
#    #    #  ####   #
#    #    ####  #   #
#    #    ###   #   #
#    #    #  ####   #
#    #    #  ####   #
#    #    #  #  #   #
###########  #######

Legend:
# - Wall
@ - Player
$ - Storage location
. - Crate