 #######
##     ##
# $ $ $ #
# #.#.# #
# #.#.# #
# $ $ $ #
# #.#.# #
# #.#.# #
# $ $ $ #
# #.#.# #
# #.#.# #
#     @ #
#######.##