 #######  
##     #  
#  $ $ #  
#  # # #  
#  # # #  
##$ # #  
#  $ $ ##  
# # # # #  
# # # # #  
# # # # #  
# # # # #  
# # # # #  
# # # # #  
# # # # #  
# # # # #  
# # # # #  
# # # # #  
# # # # #  
# # # # #  
# # # # #  
# # # # #  
# # # # #  
# # # # #  
##@# # #  
 #######  