  #############################
  #      ######  #  ###        #
  #  $ $  #   #  #  #  $ $ $   #
  # #.# # # . .  #  # #.#.# #  #
  #  #.  # $ $  ##  ##  .#.# # #
  # $# $ # . .  #    # $# $ $  #
  #  #.  # $ $  #    #  .#.# # #
  # #.# # . .  ##    ## #.#.#  #
  #  $ $ #   #  #    #  $ $ $  #
  #  ###  ####  #    #        #
  #      #      #    ##########
  #############################