 #######
 #     #
 ## ## ##
#  $ $  #
# $@$$. #
#  $ $  #
 ## ## ##
 #     #
 #######