 ####### ####### #######
 #     # #     # #     #
 # $ $ # # $ $ # # $ $ #
 # $ $ # # $ $ # # $ $ #
 # $ $ # # $ $ # # $ $ #
 # $ $ # # $ $ # # $ $ #
 # $ $ # # $ $ # # $ $ #
 # $ $ # # $ $ # # $ $ #
 # $ $ # # $ $ # # $ $ #
 # $ $ # # $ $ # # $ $ #
 # $ $ # # $ $ # # $ $ #
 # $ $ # # $ $ # # $ $ #
 # $ $ # # $ $ # # $ $ #
 # $ $ # # $ $ # # $ $ #
 # $ $ # # $ $ # # $ $ #
 #     # #     # #     #
 ####### ####### #######