 #######    #####
##     #####     ##
#  $  $    $  $   #
# #  # ## ## # # #
#  $  $    $  $   #
##     #####     ##
 #######    #####
    #####  #####
    #   #####
   ##    ###
  ##  $  $  #
 ##   $@$   #
 #  $  .  $ #
 #  $  .  $ #
 #  $  .  $ #
 ##   .$.   #
  ##  ...  #
   ## ... ##
    ###.###
      ###