 #######
 #     #
 # $.$ #
## $.$ ##
#  $.$  #
# $.$.$ #
#  $.$  #
## $.$ ##
 # $.$ #
 #  $  #
#######
#     #
# $.$ #
#  $  #
#######
 #   #
 #.@.#
 #   #
 #####