    #######
    #  ...#
    ##$#  #
     # $ $##
     #  #  #
     ##$ $ #
      # .# #
      ######
        #
        #
        #
        #
        #
        #
        #####  