##########  #########
#    #   ####   ##  #
#    # $ $  # $ $   #
#    # $ #  $   #   #
#    #  $   $ # $   #
#   $  $ $  $  #   ##
#  $ $  # $ $  #   #
# $  $ $ #  $  #   #
#  $  #   $ $  #   #
#   $   #  $ $  #  #
#   #   $ $ $  $ $ #
#  ##   $   #  $ $ #
#  #  $   $ $ $  $ #
#  #  $ $   #   #  #
##########  #########