    #######
    #     #
  ###$ $ $###
 ##  . . .  ##
##  . . . .  ##
#  . . . . .  #
# . . . . . . #
# . . . . . . #
# . . . . . . #
# . . . . . . #
# . . . . . . #
# . . . . . . #
# . . . . . . #
# . . . . . . #
# . . . . . . #
# . . . . . . #
#  . . . . .  #
##  . . . .  ##
 ##  . . .  ##
  ###$ $ $###
    #     #
    #######