####  ####
#  #  #  #
# # # #   #
# # # #   #
# # # #   #
# # # #   #
# # # #   #
# # # #   #
# # # #   #
# # # #   #
# # # #   #
# # # #   #
# # # #   #
# # # #   #
# # # #   #
# # # #   #
# # # #   #
# # # #   #
####@###$##
# # # #   #
# # # #   #
# # # #   #
# # # #   #
# # # #   #
# # # #   #
# # # #   #
# # # #   #
# # # #   #
#  #  #  #
####  ####