                    #####
                    #   #
                    #   #
                    #   #
                    #   #
      #######       #   #
      #     #       #   #
      #     #       #   #
      #  $  #       #   #
      #  .  #       #   #
      #  $  #       #   #
      #     #       #   #
      #     #       #   #
      #######       #   #
                    #   #
                    #   #
                    # @ #
                    #####
