##  ####  ####  ####  ####  ####  ####  ####  ##
#  ##  ##  ##  ##  ##  ##  ##  ##  ##  ##  ##  #
# $ $ $ $ $ $ $ $ $ $ $ $ $ $ $ $ $ $ $ $ $ $ #
# $ $ $ $ $ $ $ $ $ $ $ $ $ $ $ $ $ $ $ $ $ $ #
#  ##  ##  ##  ##  ##  ##  ##  ##  ##  ##  ##  #
##  ####  ####  ####  ####  ####  ####  ####  ##
#  ##  ##  ##  ##  ##  ##  ##  ##  ##  ##  ##  #
# $ $ $ $ $ $ $ $ $ $ $ $ $ $ $ $ $ $ $ $ $ $ #
# $ $ $ $ $ $ $ $ $ $ $ $ $ $ $ $ $ $ $ $ $ $ #
#  ##  ##  ##  ##  ##  ##  ##  ##  ##  ##  ##  #
##  ####  ####  ####  ####  ####  ####  ####  ##
#  ##  ##  ##  ##