  #####
###   #
#  $  #
#  $  #
##$ $ #
 # $  #
 #  $ #
 # $  #
 ##$  #
  #   #
  #####