   #######
   #     #
   # $ $ #
####.# #.####
#   $.$.$   #
#  #.$.$.## #
## #.$.$.  ##
 # ##.#.## #
 #   $ $  #
 #   # #  #
 ####. .####
   # $ $ #
   #     #
   #######