#    #####  #   #
#  #     #  #   #
## $ $ $ #  #   #
 # $.$.@ $  #   #
 # $ $ $ #  #   #
## $ $ $ #  #   #
#  #     #  #   #
#    #####  #   #
#############   #
               #
#############   #
#    #####  #   #
#  #     #  #   #
## $ $ $ #  #   #
 # $ $ $ #  #   #
 # $.$.$ #  #   #
## $ $ $ #  #   #
#  #     #  #   #
#    #####  #   #
#############   #