 #######
##     #
#  .$. #
# $.$  #
# $.$  #
# $.$  #
# $.$ ##
# $.$  #
# $.$  #
# $.$  #
# $.$  #
# $.$  #
# $.$  #
# $.$  #
# $.$  #
# $.$  #
# $.$  #
# $.$  #
# $.$  #
# $.$  #
# $.$  #
# $.$  #
# $.$  #
# $.$  #
# $.$  #
# $.$  #
# $.$  #
# $.$  #
# $.$  #
#  .@  #
##     #
 #######