 #####
 #   #
 #   #
 #   ######
##$ $ $  #
# .# . . #
# .#. .  #
# . # .  #
## . . . #
 ##. . . #
  ####. .#
     ####