 #######
##     ##
# .$.$  #
#.$.@.$ #
# .$.$  #
##     ##
 #######
   ######
 ###    ##
##  $.$ ##
#  $.$.$ #
# $.$.$. #
#  $.$  ##
###    ###
  ######