  #######   #####
###     ### #   ####
#  $ $ $  # # . $ $ #
# # . . # # # $ $ . #
# #  .  # # # . . # #
# # . . # # $ $ $ # #
#  $ $ $  # #   $ $ #
###     ### #   ####
  #######   #####  