 ######   #####
#    #   #   #
# $  #####  $ #
##  .@  #     #
 ### #  #  #  #
   # ##   #   #
  ##  ##  #####
 ## $  ####
 #  $  #
 # $ $ #
 #  $  #
 ######