 #####
 #   #
 # . #
 # $ #
### # ####
#  $ $  #
# #.# # #
#  $ $  #
#   #@  #
##########