                  #######
                  #     #
                  # ### #
                  # #.  #
  ####### ####### # # $ # ####### #######
  #     # #     # # #$  # #     # #     #
  # ### # # ### # # # $ # # ### # # ### #
  # #.  # # #.  # # # $ # # #.  # # #.  #
  # $ # ## $ # ## # #  $## ## $ # ## $ #
  #  $  ##  $  ## # #  $## ##  $  ##  $
  ## $ ## ## $ ## # #  $## ## $ ## $ ##
  #  $  ##  $  ## # #  $## ##  $  ##  $
  # $ ##  $ ## $ # #  $## ##  $ ## $ #
  # $ ##  $ ## $ # #  $## ##  $ ## $ #
  # $ ##  $ ## $ # #  $## ##  $ ## $ #
  # $ ##  $ ## $ # #  $## ##  $ ## $ #
  # $ ##  $ ## $ # #  $## ##  $ ## $ #
  # $ ##  $ ## $ # #  $## ##  $ ## $ #
  # $ ##  $ ## $ # #  $## ##  $ ## $ #
  # $ ##  $ ## $ # #  $## ##  $ ## $ #
  # $ ##  $ ## $ # #  $## ##  $ ## $ #
  # $ ##  $ ## $ # #  $## ##  $ ## $ #
  # $ ##  $ ## $ # #  $## ##  $ ## $ #
  # $ ##  $ ## $ # #  $## ##  $ ## $ #
  # $ ##  $ ## $ # #  $## ##  $ ## $ #
  # $ ##  $ ## $ # #  $## ##  $ ## $ #
  # $ ##  $ ## $ # #  $## ##  $ ## $ #
  # $ ##  $ ## $ # #  $## ##  $ ## $ #
  # $ ##  $ ## $ # #  $## ##  $ ## $ #
  # $ ##  $ ## $ # #  $## ##  $ ## $ #
  # $ ##  $ ## $ # #  $## ##  $ ## $ #
  # $ ##  $ ## $ # #  $## ##  $ ## $ #
  # $ ##  $ ## $ # #  $## ##  $ ## $ #
  # $ ##  $ ## $ # #  $## ##  $ ## $ #
  # $ ##  $ ## $ # #  $## ##  $ ## $ #
  # $ ##  $ ## $ # #  $## ##  $ ## $ #
  # $ ##  $ ## $ # #  $## ##  $ ## $ #
  # $ ##  $ ## $ # #  $## ##  $ ## $ #
  # $ ##  $ ## $ # #  $## ##  $ ## $ #
  # $ ##  $ ## $ # #  $## ##  $ ## $ #
  #  $ ##  $ ##  # #  $##  #  ##  $ #
  ## $ ##  $ ##  # #  $##  #  ## $ ##
  #  $  ##  $  ### #  $##  #  ##  $
  # $ ##  $ ##  ### #  $##  #  ## $ #
  # $ ##  $ ##  ### #  $##  #  ## $ #
  # $ ##  $ ##  ### #  $##  #  ## $ #
  # $ ##  $ ##  ### #  $##  #  ## $ #
  # $ ##  $ ##  ### #  $##  #  ## $ #
  # $ ##  $ ##  ### #  $##  #  ## $ #
  # $ ##  $ ##  ### #  $##  #  ## $ #
  # $ ##  $ ##  ### #  $##  #  ## $ #
  # $ ##  $ ##  ### #  $##  #  ## $ #
  # $ ##  $ ##  ### #  $##  #  ## $ #
  # $ ##  $ ##  ### #  $##  #  ## $ #
  # $ ##  $ ##  ### #  $##  #  ## $ #
  # $ ##  $ ##  ### #  $##  #  ## $ #
  # $ ##  $ ##  ### #  $##  #  ## $ #
  # $ ##  $ ##  ### #  $##  #  ## $ #
  # $ ##  $ ##  ### #  $##  #  ## $ #
  # $ ##  $ ##  ### #  $##  #  ## $ #
  # $ ##  $ ##  ### #  $##  #  ## $ #
  # $ ##  $ ##  ### #  $##  #  ## $ #
  #  $ ##  $  ### #  $##  #  ##  $
  ## $ ##  $  ### #  $##  #  ## $ ##
  #  $  ##  $  ### #  $##  #  ##  $
  # $ ##  $ ##  ### #  $##  #  ## $ #
  # $ ##  $ ##  ### #  $##  #  ## $ #
  # $ ##  $ ##  ### #  $##  #  ## $ #
  # $ ##  $ ##  ### #  $##  #  ## $ #
  # $ ##  $ ##  ### #  $##  #  ## $ #
  # $ ##  $ ##  ### #  $##  #  ## $ #
  # $ ##  $ ##  ### #  $##  #  ## $ #
  # $ ##  $ ##  ### #  $##  #  ## $ #
  # $ ##  $ ##  ### #  $##  #  ## $ #
  # $ ##  $ ##  ### #  $##  #  ## $ #
  # $ ##  $ ##  ### #  $##  #  ## $ #
  # $ ##  $ ##  ### #  $##  #  ## $ #
  # $ ##  $ ##  ### #  $##  #  ## $ #
  # $ ##  $ ##  ### #  $##  #  ## $ #
  # $ ##  $ ##  ### #  $##  #  ## $ #
  # $ ##  $ ##  ### #  $##  #  ## $ #
  # $ ##  $ ##  ### #  $##  #  ## $ #
  # $ ##  $ ##  ### #  $##  #  ## $ #
  # $ ##  $ ##  ### #  $##  #  ## $ #
  # $ ##  $ ##  ### #  $##  #  ## $ #
  # $ ##  $ ##  ### #  $##  #  ## $ #
  #  $ ##  $  ### #  $##  #  ##  $
  ## $ ##  $  ### #  $##  #  ## $ ##
  #  $  ##  $  ### #  $##  #  ##  $
  # $ ##  $ ##  ### #  $##  #  ## $ #
  # $ ##  $ ##  ### #  $##  #  ## $ #
  # $ ##  $ ##  ### #  $##  #  ## $ #
  # $ ##  $ ##  ### #  $##  #  ## $ #
  # $ ##  $ ##  ### #  $##  #  ## $ #
  # $ ##  $ ##  ### #  $##  #  ## $ #
  # $ ##  $ ##  ### #  $##  #  ## $ #
  # $ ##  $ ##  ### #  $##  #  ## $ #
  # $ ##  $ ##  ### #  $##  #  ## $ #
  # $ ##  $ ##  ### #  $##  #  ## $ #
  # $ ##  $ ##  ### #  $##  #  ## $ #
  # $ ##  $ ##  ### #  $##  #  ## $ #
  # $ ##  $ ##  ### #  $##  #  ## $ #
  # $ ##  $ ##  ### #  $##  #  ## $ #
  # $ ##  $ ##  ### #  $##  #  ## $ #
  # $ ##  $ ##  ### #  $##  #  ## $ #
  # $ ##  $ ##  ### #  $##  #  ## $ #
  # $ ##  $ ##  ### #  $##  #  ## $ #
  # $ ##  $ ##  ### #  $##  #  ## $ #
  # $ ##  $ ##  ### #  $##  #  ## $ #
  # $ ##  $ ##  ### #  $##  #  ## $ #
  # $ ##  $ ##  ### #  $##  #  ## $ #
  # $ ##  $ ##  ### #  $##  #  ## $ #
  # $ ##  $ ##  ### #  $##  #  ## $ #
  # $ ##  $ ##  ### #  $##  #  ## $ #
  # $ ##  $ ##  ### #  $##  #  ## $ #
  # $ ##  $ ##  ### #  $##  #  ## $ #
  # $ ##  $ ##  ### #  $##  #  ## $ #
  # $ ##  $ ##  ### #  $##  #  ## $ #
  # $ ##  $ ##  ### #  $##  #  ## $ #
  # $ ##  $ ##  ### #  $##  #  ## $ #
  # $ ##  $ ##  ### #  $##  #  ## $ #
  # $ ##  $ ##  ### #  $##  #  ## $ #
  # $ ##  $ ##  ### #  $##  #  ## $ #
  # $ ##  $ ##  ### #  $##  #  ## $ #
  # $ ##  $ ##  ### #  $##  #  ## $ #
  # $ ##  $ ##  ### #  $##  #  ## $ #
  # $ ##  $ ##  ### #  $##  #  ## $ #
  # $ ##  $ ##  ### #  $##  #  ## $ #
  # $ ##  $ ##  ### #  $##  #  ## $ #
  # $ ##  $ ##  ### #  $##  #  ## $ #
  # $ ##  $ ##  ### #  $##  #  ## $ #
  # $ ##  $ ##  ### #  $##  #  ## $ #
  # $ ##  $ ##  ### #  $##  #  ## $ #
  # $ ##  $ ##  ### #  $##  #  ## $ #
  # $ ##  $ ##  ### #  $##  #  ## $ #
  # $ ##  $ ##  ### #  $##  #  ## $ #
  # $ ##  $ ##  ### #  $##  #  ## $ #
  # $ ##  $ ##  ### #  $##  #  ## $ #
  #  $ ##  $  ### #  $##  #  ##  $
  ## $ ##  $  ### #  $##  #  ## $ ##
  #  $  ##  $  ### #  $##  #  ##  $
  # $ ##  $ ##  ### #  $##  #  ## $ #
  # $ ##  $ ##  ### #  $##  #  ## $ #
  # $ ##  $ ##  ### #  $##  #  ## $ #
  # $ ##  $ ##  ### #  $##  #  ## $ #
  # $ ##  $ ##  ### #  $##  #  ## $ #
  # $ ##  $ ##  ### #  $##  #  ## $ #
  # $ ##  $ ##  ### #  $##  #  ## $ #
  # $ ##  $ ##  ### #  $##  #  ## $ #
  # $ ##  $ ##  ### #  $##  #  ## $ #
  # $ ##  $ ##  ### #  $##  #  ## $ #
  # $ ##  $ ##  ### #  $##  #  ## $ #
  # $ ##  $ ##  ### #  $##  #  ## $ #
  # $ ##  $ ##  ### #  $##  #  ## $ #
  # $ ##  $ ##  ### #  $##  #  ## $ #
  # $ ##  $ ##  ### #  $##  #  ## $ #
  # $ ##  $ ##  ### #  $##  #  ## $ #
  # $ ##  $ ##  ### #  $##  #  ## $ #
  # $ ##  $ ##  ### #  $##  #  ## $ #
  # $ ##  $ ##  ### #  $##  #  ## $ #
  # $ ##  $ ##  ### #  $##  #  ## $ #
  # $ ##  $ ##  ### #  $##  #  ## $ #
  # $ ##  $ ##  ### #  $##  #  ## $ #
  # $ ##  $ ##  ### #  $##  #  ## $ #
  # $ ##  $ ##  ### #  $##  #  ## $ #
  # $ ##  $ ##  ### #  $##  #  ## $ #
  # $ ##  $ ##  ### #  $##  #  ## $ #
  # $ ##  $ ##  ### #  $##  #  ## $ #
  # $ ##  $ ##  ### #  $##  #  ## $ #
  # $ ##  $ ##  ### #  $##  #  ## $ #
  # $ ##  $ ##  ### #  $##  #  ## $ #
  # $ ##  $ ##  ### #  $##  #  ## $ #
  # $ ##  $ ##  ### #  $##  #  ## $ #
  # $ ##  $ ##  ### #  $##  #  ## $ #
  # $ ##  $ ##  ### #  $##  #  ## $ #
  # $ ##  $ ##  ### #  $##  #  ## $ #
  # $ ##  $ ##  ### #  $##  #  ## $ #
  # $ ##  $ ##  ### #  $##  #  ## $ #
  # $ ##  $ ##  ### #  $##  #  ## $ #
  # $ ##  $ ##  ### #  $##  #  ## $ #
  # $ ##  $ ##  ### #  $##  #  ## $ #
  # $ ##  $ ##  ### #  $##  #  ## $ #
  # $ ##  $ ##  ### #  $##  #  ## $ #
  # $ ##  $ ##  ### #  $##  #  ## $ #
  # $ ##  $ ##  ### #  $##  #  ## $ #
  #  $ ##  $  ### #  $##  #  ##  $
  ## $ ##  $  ### #  $##  #  ## $ ##
  #  $  ##  $  ### #  $##  #  ##  $
  # $ ##  $ ##  ### #  $##  #  ## $ #
  # $ ##  $ ##  ### #  $##  #  ## $ #
  # $ ##  $ ##  ### #  $##  #  ## $ #
  # $ ##  $ ##  ### #  $##  #  ## $ #
  # $ ##  $ ##  ### #  $##  #  ## $ #
  # $ ##  $ ##  ### #  $##  #  ## $ #
  # $ ##  $ ##  ### #  $##  #  ## $ #
  # $ ##  $ ##  ### #  $##  #  ## $ #
  # $ ##  $ ##  ### #  $##  #  ## $ #
  # $ ##  $ ##  ### #  $##  #  ## $ #
  # $ ##  $ ##  ### #  $##  #  ## $ #
  # $ ##  $ ##  ### #  $##  #  ## $ #
  # $ ##  $ ##  ### #  $##  #  ## $ #
  # $ ##  $ ##  ### #  $##  #  ## $ #
  # $ ##  $ ##  ### #  $##  #  ## $ #
  # $ ##  $ ##  ### #  $##  #  ## $ #
  # $ ##  $ ##  ### #  $##  #  ## $ #
  # $ ##  $ ##  ### #  $##  #  ## $ #
  # $ ##  $ ##  ### #  $##  #  ## $ #
  # $ ##  $ ##  ### #  $##  #  ## $ #
  # $ ##  $ ##  ### #  $##  #  ## $ #
  # $ ##  $ ##  ### #  $##  #  ## $ #
  # $ ##  $ ##  ### #  $##  #  ## $ #
  # $ ##  $ ##  ### #  $##  #  ## $ #
  # $ ##  $ ##  ### #  $##  #  ## $ #
  # $ ##  $ ##  ### #  $##  #  ## $ #
  # $ ##  $ ##  ### #  $##  #  ## $ #
  # $ ##  $ ##  ### #  $##  #  ## $ #
  # $ ##  $ ##  ### #  $##  #  ## $ #
  # $ ##  $ ##  ### #  $##  #  ## $ #
  # $ ##  $ ##  ### #