 #######
 #     #
 #     #
 #     #
 #     #
 #     #
 #     #
 #     #
 #     #
 #     #
 #     #
 #     #
 #     #
 #     #
 #     #
 #     #
 #######
  #   #
  #   #
  #   #
  #   #
  #   #
  #   #
  #   #
  #   #
  #   #
  #   #
  #   #
  #   #
  #   #
  #   #
  #   #
  #   #
  #   #
  #   #
  #   #
  #   #
  #   #
  #   #
  #   #
  #   #
  #   #
  #   #
  #   #
  #   #
  #   #
  #   #
  #   #
  #   #
  #   #
 #######