 #######
##     ##
#  .$.  #
#  @$   #
## $.$##
 #  $  #
 #  .  #
 #######