 #######
 #     #
 #     #
##$ $ $##
# $.$.$ #
##$.$.$##
 # $.$ #
 ## . ##
  #####
