 ###########
 #         #
 # $ $ $ $ #
 #  # # #  #
 ## . . . ##
 #  # # #  #
 # $ $ $ $ #
 #         #
 ###########
