 ####### ####### 
 #     # #     # 
 # $.$ # # $.$ # 
 # $.$ # # $.$ # 
 # $.$ # # $.$ # 
 # $.$ # # $.$ # 
 # $.$ # # $.$ # 
 # $.$ # # $.$ # 
 # $.$ # # $.$ # 
 # $.$ # # $.$ # 
 # $.$ # # $.$ # 
 # $.$ # # $.$ # 
 # $.$ # # $.$ # 
 # $.$ # # $.$ # 
 # $.$ # # $.$ # 
 # $.$ # # $.$ # 
 # $.$ # # $.$ # 
 # $.$ # # $.$ # 
 # $.$ # # $.$ # 
 # $.$ # # $.$ # 
 #  @  # #  $  # 
 ####### #######