  #######  
###     #  
#   $ $ #  
#  $.$  #  
#  $.$  #  
# $.$.$ #  
# $.$.$ #  
# $.$.$ #  
#  $.$  #  
#  $.$  #  
#  $.$  #  
#   $ $ #  
#   $ $ #  
### @ ###  
  #######  