 #######
 #     #
 #  $  #
 # .#  #
 #  $  #
 #.$#  #
 #@ $  #
 #. #  #
 #######