 #######
##     ##
#.$ $ $ #
#   #   #
##  #  ##
 ##. .##
 ##. .##
#   #   #
#.$ $ $ #
##     ##
 #######

          #######
         ##     ##
        #.$ $ $ #
        #   #   #
       ##  #  ##
        ##. .##
        ##. .##
       #   #   #
       #.$ $ $ #
       ##     ##
        #######