       #######
       #     #
       #     #
     ###     #
     #  $  $ #
     # .#.#. #
##### # # # # #####
#   # # # # #     #
#  $  $ $ $  $  $  #
# .#.#.#.#.#.#.#. #
#  $  $  $  $  $  #
#   #     #     #
#####     #
    #     #
    #######