  ######
##  $  #
# .$. $ #
#  .#.$ #
# $.$.$ #
## . .@##
 ######.##
     # . #
     # $ #
     # . #
     # $ #
     # . #
     # $ #
     # . #
     ## . #
      #   #
      #####
