 #####
##   ####
#  $  . #
#  $  $ #
# . $$  #
##$.$.$ #
#  $.$  #
#  # .@ #
#    #  #
#########