 ##  ######
#  ####   #
#  $  $   #
#  #  .   #
#  .  $ $ #
# # $ @ # #
# ## #  # #
#    ######
########   
