 #######   ####################
 #     ##### #                  #
 # . . . . # # . . . . . . . .  #
 # . . . . # # . . . . . . . .  #
 # . . . . # # . . . . . . . .  #
 # . . . . . . . . . . . . . .  #
 # . . . . . . . . . . . . . .  #
 # . . . . . . . . . . . . . .  #
 # . . . . . . . . . . . . . .  #
 # . . . . . . . . . . . . . .  #
 # . .