  ####
  #  #####
  #  $ $ ####
#### #.$  # ####
#   . $   # #  #
#  ## $$  #  $ #
##  $.####    ##
 # @ ##
 #####
   #
   ####