    #####
    #   #
    #   #
    #   #########
    ##$##       #
     # $        #
     # $.  ######
   ### #.#######
   #   #.#
 ### $  .#
 #  $$$.#
 # .  @##
 # .  ###
 # .   #
 # .   #
 # .####
 #$.#
 #  #
 #  #
 ## #######
### ####  #
# $$ $ $  #
#  #.#.#  #
#   .$.####
#####.#.##
    #. $  #
    #$.# $###
    #  $    #
    ##$##   #
     #   ## #
     #   #  #
     #   #  #
     #########