   #####
   #   #
   #   #####
  ##$     #
  # $ $.$ #
  # . .$  #
  # $ $.$ #
###. .$  ####
#  $ $.$    #
# @     $   #
#####   ####
    #   #
    #####