    #####
    #  ##
    #  ########
    ## $  $ $ #
#####. # # # ####
#      . . .    #
# $# # # # # # ##
#  $ . . .   # #
## ########@# #.###
 #######  # # #   #
       #    . .$  ##
       #### # # # #
           # #.  $##
           # $ $  #
           ##     #
            #######