    #####
    #   #
    #   #
#####   ####
#         #
# $ $ $ $ #
## .$ $. ##
 #   @   #
## .$ $. ##
# $ $ $ $ #
#         #
#####   ####
    #   #
    #   #
    #####