           #####
           #   #
     ####### $ ########
     #  $  $ $ $  $   .#
     # #.########  #  #    ####
    ##   . $       $#  #####  #
    #  # # ####### #  ## $    #
    #  # #        # #   #  #  #
    #  # # #######$#  # # ##$##
    #  # # #   #  #  $  # #   #
    #  $  $     $ ##  ###.##  #
    #   . ########  ## #  #  #
    ##### ########    @  #  #
        #          #     ####
        #  ########## #####
        #  .
        ######