           #####
           #   #
     ####### # #######
     #  $  $     $  $ #
     # $.$.$  #  $.$.$#
     #  $  $ # # #  $ #
     ## ###    #    ##
    #  $  $  #####  $  #
    # $.$.$ # @ # #.$.$#
    #  $  $ #   #  $  $#
    ## ###  #   #  ### #
   #  $  $   # # # $  $ #
   # $.$.$ ##   ## $.$.#
   #  $  $ #  #  #  $  $#
   ## ###    #    ### ##
  #  $  $  #####  $  $  #
  # $.$.$ #     # $.$.$ #
  #  $  $ #  #  #  $  $ #
  ## ###  #  #  #  ### ##
 #  $  $   ## ##   $  $  #
 # $.$.$ ##  .  ## $.$.$ #
 #  $  $ # #   # # $  $  #
 ## ###  #  # #  # ### ##
#  $  $  #  # #  #  $  $  #
# $.$.$ ##     ## $.$.$ #
#  $  $  #### ####  $  $ #
### ###    #   #    ### ##
   #    #  #   #  #    #
   # #  #  #####  #  # #
   #    #        #    #
   ######        ######