        ####
        #  #
  #######  #
  #  $ $ $ #
  # #.#.#. #
  # $ $ $  #
  ##.#.#.###
 ## $ $ $ ##
 # .#.#.#. #
 # $ $ $  ##
 # .#.#.#.##
 # $ $ $ $ #
 ##.#.#.#. #
  # $ $ $ $#
  #. #.#.#.#
  #$ $ $ $ #
  #. #.#.#.#
  #$ $ $ $ #
  #. #.#.#.#
  # @     ##
  #########