       #####
       #   #
 #######   #
 #  $ $ $  #
 # $$# #$$ #####
 # $  .  $ #   #
 #  $$ $$     #
##$# $@$ #  #  #
#  .  $  #######
#     $$  #
####  # $ #  ####
   #     $  #  ##
   #   $$     # #
   #####$ #### #
      #  $ $ $ #
      #   ######
      #   #
      #####
      #   #
      #   #
      #   #
      #   #
      #   #
      #   #
      #####