            #####
            #   #
      ####### $ #######
      #  $  # $ #  $  #
      # # # # # # # # #
      # .$  $.$  $.    #
      # # # # # # # # #
      #  .   .$  $  #  #
      ## ####### $ ####
     #. $ #  $  # $ #
     # ### # # # # ######
     #. $  #   #   $ $  #
     ## ### # ####### # ##
#####  #.  $  # $  #    # #
#   # # ## # # # # # ##   #
# .   $  #   #   #  $  .#  #
#   # # ## # # # # ## #   #
#####  #. $  # $  #  $.#####
     ## ### # ####### ##
     #  $  #   #   #  $ .#
     # ####### # # # # ###
     #    #  $ #  $  # . #
     ####### $ ####### ##
            # @ #
            #####