          #####
      #####     #
      #         #
      # $ $ $ $ #
      ## . .$. ##
 ###### $.$.$. #
 #   #  $. .    #
 #    # $.$######
 #  ###. . $ ##
 ##    $ $ $ # #####
 ## #         #    #
 #  #     #####    #
 #   #####     #####
 #####