            #####
            #   #
      ####### $ #######
      #  $  # $ #  $  #
      # # # # # # # # #
      # $ # $.$ # $ # #
      # # # # # # # # #
####### $ #   #   # $ #######
#     # # # # # # # # #     #
#.$.$ # # $.$.$.$.$ # # $.$.#
#     # # # # # # # # #     #
####### $ #   #   # $ #######
      # # # # # # # #
      # $ # $.$ # $ #
      # # # # # # # #
      #  $  # $ #  $  #
      ####### $ #######
            # @ #
            #####