            #####
            #   #
      ####### # #######
      #  $  $     $  #
      # $.$.$.$.$.$. $#
      #  $  $.$.$  $  #
      ##  $.$.$.$.$  ##
     #  ## $.$.$.$ ##  #
     # $  # $.$.$ #  $ #
     #  #  $.$.$  #  # #
     #  #  # $ #  #  # #
     #  #  $.$.$  #  # #
     #  # $.$.$.$ #  # #
     #  ## $.$.$ ##  # #
     ##  $.$.$.$.$  ## #
      #  $  $.$.$  $  # #
      # $.$.$.$.$.$. $  #
      #  $  $     $  ####
      ####### # #######
            #   #
            #####