    #########  ########
    #######.#  #  #  ##
    # ## $ #.#  # $$  #
    # #  $ #.#  # $  # ######
    # # # $ #.#  #  #  #....#
    # #  #  #.#  ####  #....#
    # #$    #.#     #$#....#
#####  #### #.# ####  #....#
#   ##    # ##  #  ##  #....#
# .  ######    @     ####  ##
#   .#   ###########   #####
#####.#
    #.#
    #.#
    #.#
    #.#
    # ##
    #  #
    #  #
    #  #
    ####
    ########