 #####
 #   ########
## # # $ $ $#######
#    ###   ##  #  #
#  # #  #  ##    ##
##    #..#       #
 #  # #.######  ##
 #   # ..     # #
 ##  ##.######$##
  #### $ $ $ @#
     #########