    #####
    #  ###########
    #  #         ########
    #  # $ $ $ $ $ $ $ $ #
    #  # . . . . . . . . #
    #  # $ $ $ $ $ $ $ $ #
  ###  # . . . . . . . ###
  #    # $ $ $ $ $ $ $ #
  #    # . . . . . . . #
###    # $ $ $@$ $ $ $ #
#      # . . . . . . . #
#      # $ $ $ $ $ $ $ #
#  ######. . . . . . . #
#  # $ $ $ $ $ $ $ $ $ #
#  # . . . . . . . . . #
#  ########         #  #
#####      #########  #
           #         ##
           ###########