     #######   #######
     #  #  #   ###  #  #
    ## . . # ##  # #  #
    # ..@. #####  #  ##
    ## . . #      #  #
    #  #  ### ####   #
    #######  #      ##
          # ########
          # #
          # #
          # #
          # #
          ###