            ####
    #######  # ####
    #      # # #  #
    # $$#$$ # #   #
    #  $ $  # #  $ #
##### $  $  #  $  #
#   #  $ $  # $  $#
# . #  $  $ #  $  #
#  .#   ##$##   # #
#   @         $   #
#####         ####
    ###########