           ####
           #  #
  ##########  #
  ##  $ $ $   #
  #  .$.$.$. ##
  #  $ $ $  ###
  ##.$.$.$. #
#### $ $ $  #
# . .$.$.$ ##
#  $ $ $  ###
##.$.$.$.  #
 #  $ $ ####
 # .$.$ # #####
 ##.$.$ # #   #
  #  $ $ #   @#
  #   # ####  #
  #####      ##
      #      #
      ########