    #####
    #   #######
    #  $  $ $ #
    ## .#.#.#.##
##### . $ @ $ . #####
#   # .#.#.#. #   #
#  ## $ $  $  #   #
#   #######   #####
#####     #####