       #####
 #######   #
## $      $###
# $ #  #  #  #
#  .#..#..#  #
## #  #  # $ #
#  #  #  #   #
#  #  #  #@  #
#     #     ##
####### #####
     #     #
     #######