       ###### ###### #######  ######
 #######    # #    ########  #    #########
 #     # .#. # # .#. #######  # .#. #     #
 # ### #     ###     #########     # ### #
 # ### ### #### #### ##  #### ### ### ### #
##    #  ###  ##  ###    #  ###  #    #    #
#  # ## ## ## ## ## ## ## ## ## ## ## #  #
#   .###     # #     ###  .###     ###   #
# # ## ## ## ## ## ## ## ## ## ## ## # #
#  #  #  ###  ##  ###  #  ###  #  ###  # #
## # ## ### #### #### ### #### ### ## # #
 #     #     # #     #  .# #     #     #
 # .#. # .#. # # .#. # ##  # .#. # .#. #
 # ### ##    ###    ##  ####    ## ### #
 ####### ########### #### ####### ######
       ########### #### #######       #
             #### #### ####### .#.  $ #
             #  # #  #  #  #  #     ###
             # ## # ## # ## ## ## ##  #
             #  # #  #  #  #  #  #  #  #
             ## ## ## ## # ## ## ## ## #
              #  # #  #  #  #  #  #  # #
              #### ####### #### #### ###
              #### ####### #### #######
              #  # #  #  #  #  #  #  #
              # ## # ## # ## ## ## ## #
              #  # #  #  #  #  #  #  #
              ## ## ## ## ## # ## ## #
               #  # #  #  #  #  #  # #
               #### ####### #### #### #
               #### ####### #### #### #
               #  # #  #  #  #  #  #  #
               # ## # ## # ## ## ## # #
               #  # #  #  #  #  #  #  #
               ## ## ## ## # ## ## ## #
                #  # #  #  #  #  #  # #
                #### ####### #### #### #
                #### ####### #### #### #
                #  # #  #  #  #  #  # #
                # ## # ## # ## ## ## #
                #  # #  #  #  #  #  #
                ## ## ## ## # ## ## #
                 #  # #  #  #  #  # #
                 #### ####### #### #
                 #### ####### #### #
                 #  # #  #  #  # #
                 # ## # ## # ## #
                 #  # #  #  #  #
                 ## ## ## ## # #
                  #  # #  #  # #
                  #### ####### #
                  #### ####### #
                  #  # #