   #####
   #   #
   # # ####
 ###$.#  #
 # $ ... #
 #  #. . ##
 ## ##. $ ######
 #  #. # $ $ $ #
 # $  .  #     #
### #### # #####
#@  #    $ #
########## #
         # #
         # #
         # #
         # #
         # #
         ###