      #####
      #   #
      # # ####
    ### # #  #
    #   # $  ##
    # # #.####
##### # # ######
#   # # #  ....#
# $   $ # $#$..#
## ##  #    #..#
 #     # $ $  ##
 #   #  #  #   #
 ###### #  #####
      # # #
    ### # #####
    #  $  $   ##
    #.# $ #$#  #
    #....  # ####
    #....$ # #  #
    #..$#$ $   $#
    #..#  # ## ##
    ##  #    #  
     ##  #####
      # #
      # ###
      #   #
      #####