     #####
   ###   #  ####
   #  $ $####  #
   # $  $   $$ #
   #  # #.## # ###
 ###. . . . . . #
 #  # #.## # #.###
 #  . . . . . . #
 ## # #.## # #. #
  # . . . . . . #
  ### #.## # # ###
  # . . . . . . #
  ## # #.## # # #
 #  . . . . . . #
 # # #.## # # ###
 #  . . . . . . #
 ### #.## # #. #
   #  # #.##. ###
   # $$   $ $  #
   # ####$ $  $#
   #  ####  #  #
   ####  #   ###
     #  #####
     ####