  #####
  #   #
### # ####
#  $  $  #
# #.#.#. #
## .@.   #
 #########