###############################
#  #  #  #  #  #  #  #  #  #  #  #
#  #  #  #  #  #  #  #  #  #  #  #
#. #  #  #  #  #  #  #  #  #  # .#
#  .  .  .  .  .  .  .  .  .  .  #
# $ $ $ $ $ $ $ $ $ $ $ $ $ $ $ $#
# $ $ $ $ $ $ $ $ $ $ $ $ $ $ $ $#
#  .  .  .  .  .  .  .  .  .  .  #
# #  #  #  #  #  #  #  #  #  #  #.
#  #  #  #  #  #  #  #  #  #  #. #
#  #  #  #  #  #  #  #  #  #  #  #
#  @                           . #
###############################