      #####
      #   #
      # $ ####
      #  $ #  #
      ##$  $   #
     ##  $$ $  #
     #  $ . .# ###
   ### # . . $  #
   #  $  . . $# ##
 ### # $ . .  $  #
 #  $  $$ $ ##   #
 #   $    #  ####
 ####  @  #
    #      #
    ########