      #####
      #   #
      # $ ####
      #  $ #  #
      ##$  #  #
     ##  #  $###
     #  # $ $ @#
     # #   #  ##
  #####  $  $##
  #   # $$ # #
  # . .   #  #
  #   . . .  #
  ###. . .  ##
    # . .  ##
    ####  ##
       #  #
       #$ ##
       #  #
       #  #
       #  #
       #  #
       #####