           #####
      ######   #####
      #    # $  $   #
      #  $ # $ $  $  #
      #  .. .@. ..$  #
      #  $ # $ $  $  #
      #    # $  $   ##
      ###  #### #####
        ####
  ######  #
  #      ##
  # $$ $  #
  # .  .  #
  # $$ $ ##
  #      #
  ########