       ####
  ######  #.#
  #   #   #.########
  # $   $ #......  #
  #  # #  #......   #
#### # #$####### $  #
#  # # # $  #  #  $  #
#    $ #  $   $  $   #
#.#.###@##############
#    $    #
#   #  #  #
##########
    ###