            #####
            #   #
            # $ #######
   ########## # # #    #
   #....  # ## # #   # #
   #....  # ## # #  #  #
  ##....    # # #  #  ##
  # ##.##   # # ####  #
 ##  ..###$$@  #     ##
 #  #....#  #  #### ####
 #  #....   #     # #
 #  ###.#   ####### #
 #    #.#      #    #
 ######.#########   #
      #.# #     #   #
      #.# #######   #
      #.#     #
      ####   #
         #   #
         #####