  #####
  #   ###########
### # #         #
#   # #  $  $  $ #
# # $ $ .#.#.#.#.#
#  $ #  # $ $ $ @#
## ######.#######
 ####    # #
    #  # # #
    ####   #
      #  #####
  #####  #
  #      #
  #  #####
  ####