     #####
     #   #
  ##### ####
  #  $$.  .######
  # #  ..$. $  @#
  #  ## ...#  $ #
  ## #  ..###### #
 ##  $$.  #     ##
 #   # #### #####
 #   # # $ $ #
 ##### ### ###
     #     #
     #######