      #####
 ######   #####
 #    # .$.   #
 #  $ # $ $ $# #####
 ## $ ##### $    # #####
 #  $       #    # #   #
 # $ $ $ $ $ ##### # # # ####
 #  $ #.    $      # # # #  #
 #   @.        $$  # # #    #
 ############################