    ####
  ###  #
  #  $##
  # . ##
####. $###
#   .$.  #
#  $.$   #
## $@$$  #
 ####   ##
   ##  ##
    ####