      #####
      #   #
      # # ####
      # # #  #
      # # $  #
      # # #$ ####
      # # #. .  #
      # # #.$   #
      # # #. . ####
      # # #.$  #  #
      # # #. ####  #
      # # #.$ #    #
      # # #. $#    #
      # # #.$ #    #
      # # #. ####  #
      # # #.$  #  #
      # # #. . ####
      # # #.$   #
      # # #. .  #
      # # # $  ##
      # # ###$ #
      ###   # #
        # @# # #
        ##### # #####
            # # #   #
          ### # #$  #
          #   # # ####
        ####  # # #
        #  #  # # #
        #    $ # # #
        #    . # # #
        ####  # # #
           #  $ # #
           #. . # #
           #    $ #
           #    . #
           ####  ##