######
#   ###
# .$ ###
# $$  ##
##  # ###
 ## .   #
 #   $$ #
 # ###  #
 #  $$.##
##   # ##
#  @  # 
########