    ####
    #  #
    #  #
    #  #
    #  #
    #  ####
    ##$ #.#
##### #  #
#   ###  #
#      $ ##
#  ## #  #
##    .  #
 ####. $ #
  #  # ####
  #  #
  #  #
  #  #
  #  #
  ####
    ####