           #####
           #   #
     ####### $ #######
     #  $  $ $ $  $  #
   ### #  $ # # $  # ###
   #  $  $ #   # $  $  #
 ### #  $  #.#  $  # ###    ####
 #  $  $  #...#  $  $  #    #  #
 # #  $  #.....#  $ # #    #   #
 #  $  #.......#  $ #    #  $ #
### # #.........# #    # #  $#
#  $ #...........#    #  $  #
#   #.............#  #######
#  @#.............#
#######........#######
      #........#
      #........#
      #........#
      ##########