############################
#                          #
#  $ $ $ $ $.$.$ $ $ $ $ $ #
#  $ $ $ $      $ $ $ $ $  #
#  $ .$.$ $ ## $ $.$.$ $  #
#   .      ###      .     #
#  $.$.$ $ ## $ ## $.$.$  #
#   .      #  $      .     #
#  $.$.$ $  @ $  $.$.$.$  #
#   .      #  $      .     #
#  $.$.$ $ ## $ ## $.$.$  #
#   .      ###      .     #
#  $.$.$ $ ## $ $.$.$ $  #
#  $ $ $ $      $ $ $ $ $  #
#  $ $ $ $ $.$.$ $ $ $ $ $ #
#                          #
############################