#############
#  # # # #  #
# #  .$.  # #
## $.$.$.$ ##
 # $.$@$.$ #
## $.$.$.$ ##
# #  .$.  # #
#  # # # #  #
# #  .$.  # #
## $.$.$.$ ##
 # $.$.$.$ ##
## $.$.@.$ ##
# #  .$.  # #
#  # # # #  #
# #  .$.  # #
## $.$.$.$ ##
 # $.$.$.$ ##
## $.$.$.$ ##
# #  .$.  # #
#  # # # #  #
# #  .$.  # #
## $.$.$.$ ##
 # $.$.$.$ ##
## $.$.$.$ ##
# #  .$.  # #
#  # # # #  #
# #  .$.  # #
## $.$.$.$ ##
 # $.$.$.$ ##
## $.$.$.$ ##
#  # # # #  #
#############