###############################
#  #  #  #  #  #  #  #  #  #  #  #
#  #  #  #  #  #  #  #  #  #  #  #
# #  #  #  #  #  #  #  #  #  #  #
# #  #  #  #  #  #  #  #  #  #  #
# #  #  #  #  #  #  #  #  #  #  #
# #  #  #  #  #  #  #  #  #  #  #
# #  #  #  #  #  #  #  #  #  #  #
# #  #  #  #  #  #  #  #  #  #  #
# #  #  #  #  #  #  #  #  #  #  #
# #  #  #  #  #  #  #  #  #  #  #
# #  #  #  #  #  #  #  #  #  #  #
# #  #  #  #  #  #  #  #  #  #  #
# #  #  #