             #####
     #########   ##
     #  $ $ $ $ . ##
   ### # # # # #$###
   #   $ $ $ $  $  #
 ### ## # # # # # ####
 #   $  $ $ $ $ $  $  #
 # # ## # # # # # # ## #
 #  $  $ $ $ $ $  $  $  #
## # # # # # # # # # ## #
#  $  $ $ $.$ $ $ $  $  #
# # # # # # #@# # # # # #
#  $  $ $ $.$ $ $ $  $  #
## # # # # # # # # # ## #
 #  $  $ $ $ $ $ $  $  #
 # # ## # # # # # ## #
 #   $  $ $ $ $  $  #
 ### ## # # # # ####
   #  .$ $ $ $ $  #
   ## $ # # # # # ###
    ##. $ $ $ $  $  #
    ##.   #   #   @#
    ######   ######