#############################
#  #  #  #  #  #  #  #  #  #  #
# $.$.$.$.$.$.$.$.$.$.$.$.$. #
# $.$.$.$.$.$.$.$.$.$.$.$.$.$#
##$.$.$.$.$.$.$.$.$.$.$.$.$.$#
# $.$.$.$.$.$.$.$.$.$.$.$.$.$#
# $.$.$.$.$.$.$.$.$.$.$.$.$. #
# $.$.$.$.$.$.$.$.$.$.$.$.$. #
# $.$.$.$.$.$.$.$.$.$.$.$.$. #
# $.$.$.$.$.$.$.$.$.$.$.$.$. #
# $.$.$.$.$.$.$.$.$.$