############################
#  $ $ $ $ $ $ $ $ $ $ $ $  #
# $ $ $ $ $ $ $ $ $ $ $ $ $ #
#                         $ #
# $ $ $ $ $ $ $ $ $ $ $ $ $ #
# $ $ $ $ $ $ $ $ $ $ $ $ $  #
#  $ $ $ $ $ $ $ $ $ $ $ $   #
#   $ $ $ $ $ $ $ $ $ $ $    #
# @  $ $ $ $ $ $ $ $ $ $  .  #
#   $ $ $ $ $ $ $ $ $ $ $    #
#  $ $ $ $ $ $ $ $ $ $ $ $   #
# $ $