     #####
     #   #
  ##### $ ####
  # . . .  # ####
  #  # # ## # #  #
  # #  $ . $ #   #
###  # # ##$### ##
#  $  . . # $ $  #
# @## # ## # #   #
#####   #  . . . #
    #### $ ######
       #   #
       #####