           ####
           #  #
  ####     #$ #
  #  #     #  #
  # $#######  #
  # ....   # ##
  # ....   # $#
  ### ###  #  @#
# $  $ $  #####
#  #     ##
####     #
           #
           ####