################################
# ............................. #
# .$.$.$.$.$.$.$.$.$.$.$.$.$.$. #
# $.$.$.$.$.$.$.$.$.$.$.$.$.$.$ #
# .$.$.$.$.$.$.$.$.$.$.$.$.$.$. #
# $.$.$.$.$.$.$.$.$.$.$.$.$.$.$ #
# .$.$.$.$.$.$.$.$.$.$.$.$.$.$. #
# $.$.$.$.$.$.$.$.$.$.$.$.$.$.$ #
# .$.$.$.$.$.$.$.$.$.$.$.$.$.$. #
# $.$.$.$.$.$.$.$.$.$.$.$.$.$.$ #
# .$.$.$.$.$