###########
#    #    #
# #  #  # #
#  $.$.$  #
# # .$.# # ######
#  $.$.$  #    ##
## #.#.# # # # # ####
 #  $.$.$  #    #   #
 # # .$.# # #  #### # ####
 #  $.$.$  #    ## . .  . #
 # #  #  # # # # ## . #. ##
 #  $.$.$  #    #   . .  #
 # # .$.# # #  ###########
 #  $.$.$  #    #
### #.#.# # # # #
## #.$.@.$.# # #
#  $.$.$  #
# #  #  # #
#  $.$.$  #
# #  $   $ #
#    #    #
###########