     #####
  ####   ###
  #  .$. . ##
  # #.$.$.  #
  #  $.#.$# ####
  ##$#.$. # #  #
  #  $.$.# $ $ #
  # $ $ #.$ .  #
### . $.#.$# ###
#  $ @   $ $  #
#  #     $  ##
#### #$.$#  #
   ## .$.   #
    ###   ###
      #####