###################
#    #    #    #   #
# #  # #  # #  # # #
#    #    #    # $ #
## ###########     #
#    #    #    # #$#
# #  # #  # #  # #.#
#    #    #    # #$#
## ###########  #. #
#    #    #    # #$#
# #  # #  # #  # #.#
#    #    #    # #$#
## ###########  #. #
#    #    #    # #$#
# #  # #  # #  # #.#
#    #    #    # $ #
## ###########  #. #
#    #    #    # $ #
# #  # #  # #  # #.#
#    #    #    # $ #
## ###########  #. #
#    #    #    # $ #
# #  # #  # #  # #.#
#    #    #    # $ #
#   #    #    #    #
###################