       #######
       #  #  #
 #######. . .########
 #  #  #..... .#  #  #
 #   $. . $ $ .     #
 #  # ..$.$ @ $..  # #
## ##$.$  . $  $.## ##
#  #  .. $ $  ..  #  #
# ##   . .$ $.   ##$##
#  #  #..... .#  #  #
######. . . . ######
      ### ###