    ####   ####
  ###  #####  ####
 ##    ##  # $$  #
 #  ##  # #  $  $ #
 # #  # # # $  $  #
 # # # #  #  $  $ #
 # #  # # # $  $  #
 # # # # #  $  $ ##
 # #  #  # $  $$ #
 #  ## #  #  $$  #
 ##  #  ## #  ####
  ## @  ##  ##
   ####  ####