     ####
######  #
#      $#
#  $  #.#
#  #  #.##
## #  #  #
 # # $#  #
 # #  $@ #
 # #      #
 # ########