     #######
     #  #  #
######  #  ######
#      @ #     #
#  #  #   # #  #
#  # #. $ .# # #
#     .$ $.     #
# # #. $ .# #  #
#     .$ $.     #
# # #. $ .# #  #
#     .$ $.     #
#  # #. $.# #  #
#  #  #   # #  #
#     # $  .   #
######  #  ######
     #  #  #
     #######