    #####
    #   #
    #   #    #####
    #   ######   #
    #   $ $ $    #
#####.# $  $  ####
#     .#$ $  ##  #
#  @    $ $ ##   #
#     .###$ ##   #
#####.#     #   ##
    #.  #### $ $ #
    #. ##  ##   $#
    #.     #    $#
    ###### ####  #
         #      ##
         ########