#############################
#  #  #  #  #  #  #  #  #  #  #
# $.$.$.$.$.$.$.$.$.$.$.$.$.$ #
#  .  #  .  #  .  #  .  #  .  #
### ### ### ### ### ### ### ##
#  .  #  .  #  .  #  .  #  .  #
# $.$.$.$.$.$.$.$.$.$.$.$.$.$ #
#     #     #     #     #    #
# ### ### ### ### ### ### ### #
#     #     #     #     #     #
# $.$.$.$.$.$.$.$.$.$.$.$.$.$ #
#  .  #  .  #  .  #  .  #  .  #
### ### ### ### ### ### ### ###
#  .  #  .  #  .  #  .  #  .  #
# $.$.$.$.$.$.$.$.$.$.$.$.$.$ #
#    #     #     #     #     #
# ### ### ### ### ### ### ### #
#     #     #     #     #     #
# $.$.$.$.$.$.$.$.$.$.$.$.$.$ #
#  .  #  .  #  .  #  .  #  .  #
### ### ### ### ### ### ### ###
#  .  #  .  #  .  #  .  #  .  #
# $.$.$.$.$.$.$.$.$.$.$.$.$.$