#############       #
#           #  ##### #.#
#    #####  ####   # #.#
#    #   ####  $   #   #
#  $  $  #  #  $   $  $#
####  #    #   ## $ #  ####
#####  #   #  ##  # $ $ #####
#####    # ####  #  $  $#####
########## #### # $  $  #####
#####    # #### #  $  $ #####
#####  #  #  ## #   $ $ #####
####  #  $  #   ## $ #  ####
#  $  $   ###   #   #
#  $   #### #$  #   #
#  ####   #  ####   #
#        #    #####.#
#   ###### #@      #.#
#####    # #### # $ #.#
#####  #  #  ## #   #  ##
#####  # $ #  #  #   #  #
##### $  $ #  $  #   #  #
#####  # $ #  $  #   #  #
####  #  $ #   ##   #  #
#  $  $   ##   ####  $  #
#  $   ####  $  #  #   ##
#  ####   #  #### # $ #
#        #    #  # $  #
#   ######      #  $  #
#############   #  $  #
              #####  ##
              ############