      #####
      #   #
      # # ####
      # # #  #
      # #    #
      # #$ # #
      # #. . #
      # #    #
      # # $$ #
      # # ####
      # # #  #
      # #    #
      # #$ # ####
      # #. . #  #
      # #    $  #
      # # $$ #  #
      # # ####  #
      # # #  ####
      # #    #
      # #$ # #
      # #. . #
      # #    #
      # # $$ #
      # # ####
      # # #  #
      # #    #
      # #  @ #
      ########