    #####
    #   #
##### # #####
#   #     # #
#  $  $ #   #
## $###$$#  #####
 # $ # # ####   #
 #  $ ### $  $  #
 # $  #.  $ $  ##
 ### #.### $ ##
   #  .  #  ##
   # #@ $# #
   #  .    #
   #########