  #####
  #   #
  # # ####
  # $ $ #
  #  #  ####
  ##. ##   #
  # $ $    #
  #  # ### ####
  ## ##   #   #
  # $ $    #  #
  #  # #  #   #
  # $ $ ##  # #
  #  #  #   # #
### ## ## # # #
#   #   # # # #
# @       # # #
#   ## ## # # #
##### # # # # #
    # # # # # #
    # # # #   #
    # #   # $  #
    #   ## ##  #
    # # # # #  #
    # # # # ####
    # # # # #
    #         #
    ###########