     #######
######     ######
#     # # # #   #
# ### . .$. .### #
## $  $ #.#  $$  #
#  ##. .@+$. .## #
# $  $$ #.#  $  ##
# ### . .$. .### #
## # # #   # #   #
#   #       #   ##
# # ####### # # #
#             $ #
############### #