####################################
###.    .    .    .    .    .    .###
#  $ $ $ $ $ $ $ $ $ $ $ $ $ $ $  #
# $ $ $ $ $ $ $ $ $ $ $ $ $ $ $ $ #
#                                 #
# $ $ $ $ $ $ $ $ $ $ $ $ $ $ $ $ #
# $ $ $ $ $ $ $ $ $ $ $ $ $ $ $ $ #
#                                 #
# $ $ $ $ $ $ $ $ $ $ $ $ $ $ $ $ #
# $ $ $ $ $ $ $ $ $ $ $ $ $ $ $ $ #
#                                 #
# $ $ $ $ $ $ $ $ $ $ $