#############################
#.      #    #    #    #     #
# ##  # # ## # ## # ## # ## ##
#   #  $  #  $  #  $  #  $   $#
#   #     #    #    #    #    #
#   ######################### #
#   $  #  $  #  $  #  $  #  $  #
#      #    #    #    #    #  #
# ## # ## # ## # ## # ## # ## #
#  $  #  $  #  $  #  $  #  $   #
#     #    #    #    #    #   #
########### ################# #
#   #  $  #  $  #  $  #  $  #  #
#   #     #    #    #    #    #
#   ######################### #
#   $  #  $  #  $  #  $  #  $  #
#      #    #    #    #    #  #
# ## # ## # ## # ## # ## # ## #
#   $  #  $  #  $  #  $  #  $  #
#      #    #    #    #    #  #
# ## # ## # ## # ## # ## # ## #
#   #  $  #  $  #  $  #  $   $ #
#   #     #    #    #    #    #
#   ######################### #
#   $  #  $  #  $  #  $  #  $  #
#      #    #    #    #    #  #
# ## # ## # ## # ## # ## # ## #
#  $  #  $  #  $  #  $  #  $   #
#     #    #    #    #    #   #
# ##  # ## # ## # ## # ## #  @#
#      #    #    #    #       #
#############################