############################
###  #######  #######  #####
### .$ .   #.$ .   #.$ .   #
#  $.$.$   # $.$.$   # $.$.$#
#   .   ## #   .   ## #   . #
# ## ##  # # ## ##  # # ## ##
#   .    # #   .    # #   .  #
## ## ## # # ## ## # # ## ## #
#  .  .  # #  .  .  # #  .  . #
# $ $ $  # # $ $ $  # # $ $ $ #
#  .  .  # #  .  .  # #  .  . #
## ## ## # # ## ## # # ## ## #
#   .    # #   .    # #   .   #
# ## ##  # # ## ##  # # ## ## #
#   .   ## #   .   ## #   .   #
# $.$.$   # $.$.$   # $.$.$  #
#   .   #.$ .   #.$ .   #    #
# ##  #### # ##  #### # ## ##
#   .    @ #   .    # #   .  #
# ## ##  # # ## ##  # # ## ## #
#   .   ## #   .   ## #   .   #
# $.$.$   # $.$.$   # $.$.$  #
#   .   #.$ .   #.$ .   #    #
############################