    #####
    #   ####
    # $ $  #
#####.$.  #
#   .  $ ##
#  ..$ @ #
##$..  ####
 # $$  #
 #   ###
 #####