############################
#                          #
# .$.$.$.$.$.$.$.$.$.$.$.$. #
# $.$.$.$.$.$.$.$.$.$.$.$. #
# .$.$.$.$.$.$.$.$.$.$.$.$. #
# $.$.$.$.$.$.$.$.$.$.$.$. #
# .$.$.$.$.$.$.$.$.$.$.$.$. #
# $.$.$.$.$.$.$.$.$.$.$.$. #
#         $.$.$.$.$.$.$      #
# $.$.$.$.$.$.$.$.$.$.$.$. #
# .$.$.$.$.$.$@$.$.$.$.$.$. #
# $.$.$.$.$.$.$.$.$.$.$.$. #
# .$.$.$.$.$.$.$.$.$.$.$.$. #
# $.$.$.$.$.$.$.$