     #####
     #   #
  #### . ####
  #   $.$   #
  # $.. ..$ #
### .#$ $#. ###
#  $ $   $ $  #
# $ .#$ $#. $ #
#  $ $   $ $  #
## .#$ $#. . ##
 # $..@..$ #
 #   $.$   #
 #### . ####
    #   #
    #####