        #####
        #   #
        #   ######
        #      $ #
        #   $$   #
        #  $##   #
        ###  #   #
         #  @#  ##
         # .  ###
         ###$ #
           #  #
           #  #
      ######  #
      #   #   #
      # . #   #
      #$  #####
      #   #
      #   #
      #   ######
      #      $ #
      #   $$   #
      #  $##   #
      ###  #   #
        #  ##
        # ##
        # #
        ###