    ####     ########
    #  #######      ##
    #       $   ##   #
    #  ######.####    #
    # ##  # $ $       #
    # # $      ##  #  #
    # #  #  ##    ##  #
    # #  ## #  #  ##  #
    # #  #  # .  . ## #
    # #  #  #    ##   #
    # ## # ##  ##  #  #
    # #  #  #  #   #  #
    # #  #  #  #   #  #
    # #  #  ## ### #  #
    # #  #  #  #   #  #
    # #  #  #  #   #  #
    # #  #  #  #   #  #
    # #  #  #  #   #  #
    # #  #  #  #   #  #
    # #  #  #  #   #  #
    # #  #  #  #   #  #
    # #  #  #  #   #  #
    # #  #  #  #   #  #
    # #  #  #  #   #  #
    # #  #  #  #   #  #
    # #  #  #  #   #  #
    # #$ #  #  #  $#  #
    #    #  #  #  $   #
    #.########.######@#
    #          $      #
    ########     ######