     #### #
  #####  # #
 ## .  #   #
 # .$.#  # ### ######
## $.  # #  #  #    #
#  $.$ #  #  #  # # ##
#   $ ##    ## ## # #
##   @#  #      #   #
 #####   # ### #  # #
     #####   #####  #
         #####     ##
             #####