     #######
######     ######
#     # # # #    #
# # # #  $ $  # # #
#  $  # $   $ #  $ #
# $   #  $ $  #   $#
#  $  # $   $ #  $ #
# $   #  $ $  #   $#
#  $  # $ $ $ #  $ #
# $   $  $@$  $   $#
#  $  # $ $ $ #  $ #
# $   #  $ $  #   $#
#  $  # $   $ #  $ #
# $   #  $ $  #   $#
# # # #  $ $  # # #
#    # # # # #    #
######     ######
     #######