####
#  #######
#     #  ##
#  #  $  $#
## ####   #
 # #  #.###
 #   @ $ #
###.#.####
#  $  #####
# #  ##
#  $  #
# ##  #
#  ####
####