  #####
  #   #####
### # #   #
#   # # # ####
# # # # # #  #
# #   $ $ $$.##
##. $$     . #
 # .     $$  #
 ####.# # # @#
    #####   #
        #####