       #####
       #   #
  ###### # ######
  #   #  $  #   #
  #  $   .   $  #
 ### .#$...$#. ###
##  $.$.$@$.$.$  ##
# . #$.#...#.$#. #
#  $   .   .   $  #
# . #$.#...#.$#. #
##  $.$.$.$.$.$  ##
 ### .$...$. ###
  #  $   #   $  #
  #   #######   #
  ##### # #######
        # #
        #####