   #####
   #   #
   #   #
 ### ####
 ## .$. #
 #  $$$ #
 # .$$.######
##       $ $ #
# $ $       $#
######.$$.  $.#
     # $$$  $ #
     # #@#  ###
     #####