     #######
     #  #  #
######  #  ######
#   #       #   #
# #   ###       #
# $  $  #  ##  ##
##  $ $ #  ####
####  ###   #
   ## $ #   #
   # $  #####
   #  $  #
   #  ####
   ####
   #  ####
   #  $  #####
#### $ # $  #
# $  $ #  $ ##
#  ##  #  $  #
##  ####   # #
##   ### $  # $
#       # ### #
######  #  # @#
     #  #  #  #
     #######