##################################
#                                #
#  ############################  #
#  # .  .  .  .  .  .  .  .  . #  #
#  ##$##$##$##$##$##$##$##$## #  #
#  # .  .  .  .  .  .  .  .  . #  #
#  #  ###################### #  #
#  # .  .  .  .  .  .  .  .  . #  #
#  # ##$##$##$##$##$##$##$## #  #
#  # .  .  .  .  .  .  .  .  . #  #
#  #  ###################### #  #
#  # .  .  .  .  .  .  .  .  . #  #
#  ##$##$##$##$##$##$##$##$## #  #
#  # .  .  .  .  .  .  .  .  . #  #
#  #  ###################### #  #
#  # .  .  .  .  .  .  .  .  . #  #
#  # ##$##$##$##$##$##$##$## #  #
#  # .  .  .  .  .  .  .  .  . #  #
#  ############################  #
#                                #
#                                #
##################################