      #####
      #   #
      #   #
      #   #
      #   #####
      #     $ #
      #  $  . ###
      ##.###.  #
       #  $ $ #
       # ##.###
     ###.###.##
     # $ $  .#
     # $     #
     #.#######.#
     # $     $ #
     # $ ### $ #
     #.###@###.#
     # $ ### $ #
     # $     $ #
     #.#######.#
     # $     #
     # $ $  .#
     ##.###.###
      #  $ $ #
      # ##.###
      ###.###  #
        #  .  ##
        ## ### #
        # $     #
        #   #   #
        #   #   #
        #####   #