     #### ####
######  ###  ########
#     # # # ##  #   #
# ###.$ . . .#     ##
#  $ .#   # # ### ###
## ### ### # # $ $ #
 # # $ $ $ # # # # #
 #  $  #   # # # # #
 #  ####  ## # # # ####
 ## #  #$$   $  $  $  #
 #  #. . $##        # #
 # #.    .$ ## # # ## #
 #  .  # #  #### . #  #
 # #.    .  #  # . # ##
 #  #. . #  #  # . #$
####  ###   #  #####
#   ## ###  ####
##    @  ####
#####  ####
#   ####
#  ##
####
#