###########
#@    #   #
#  #$. $  #
#     . #####
######.###  #
  ## .##    #
  #  $.     #
  # $ $ $  ##
  # $ $ $ #
 ## $ $ $ #
 # $ $ $$##
 # $ $ $ #
 # $ $ $ #
 # $ $ $##
## $ $ $ #
# $ $ $$ #
# $ $ $ $#
# $ $ $ $#
#     .$ #
######.# ###
     #    #
     ## . #
      # $ #
      #   #
      #####