#############################
#.      .      .      .      #
# ##  # #  ## # #  ## # #  ## #
#   # # # #  $ # #  $ # # #  $#
##$  $  $ ##   $ ##   $ ##   ##
#   # # # #  $ # #  $ # # #  $#
# ## # #  ## # #  ## # #  ##  #
#      .      .      .      . #
#.##  # #  ## # #  ## # #  ##$#
#   # # # #  $ # #  $ # # #  .#
# $  $  $ ##   $ ##   $ ##   ##
#   # # # #  $ # #  $ # # #  .#
# ## # #  ## # #  ## # #  ##  #
#      .      .      .      . #
#  ## # #  ## # #  ## # #  ## #
#$  $  $ ##   $ ##   $ ##   $##
#  @  # # #  $ # #  $ # # #  $#
#      .      .      .      . #
#############################