            #####
            #   #
   ######  ###$ # ######
   #    ####  $ # #   #
   #      $  $ $      #
  ##  $##  $ $  ##$   #
  #  $  $ $ $ $ $ ##  #
  # $ $ $ $.$ $ $ $ #$#
  #  $  $ $ $ $ $ ##  #
  ##  $##  $ $  ##$   #
   #      $  $ $      #
   #    ####  $ # #   #
   ######  ###$ # ######
         # @   #
         ##### # ######
               #     #
      ###### ###  #  #
      #    #  $ $  $  #
      #    # $   $ $  #
      #    #  $ $  $  #
      #    ###  #  #  #
      #      #     #  #
      ######### #######