     ####   ####
######  ####  # ####
#      @ #  ####   #
# ###### #  ##  $  #
# #....  $  #  # $ #
# # ...# ### # ##  #
# # ....  # #    $ #
# ### ### # #  #   #
#     #   # ########
#####   ###