        ####
   ######  #
   #   $   #
   #  #.#  #
 ### #.# ###
 #  $ # $ #
 # .@. .  #
 #  $ # $ #
 ### #.# ###
   #  #  #
   #   $ #
   #######