             #####
            ##   #
            #    #
            # # ##
            #    #
            ## # ####
            #    #  #
            # ## $   #
            #  $  #$.#
           ##  ###$.##
           #  ## #.$.#
           #  #  #.$.##
     ####  #  #  $... #
     #  ##### ## $...#
     #       # ## $..#
     #  ## # #   $..##
     ## # ##  #  $..#
     #  # #   ## $..#
     #    #  # ## $..#
     #  @ # ## # $...#
     ###  # #  # $...#
     # ##  # # ##$...#
     # ##  # #  $...##
     # ##  #  ##$...#
     # ##  ##  $...##
     # ##  #  $...#
     #####  $...  #
         #   $  ##
         ##  ####
          ###