    ####
    #  #
    #  #####
#####  ####
#####$ $ #
#  . ..  #
#  $ $ ###
##    $##
 #####@#
 #   $ #
 #  ####
 #######
 #     #
 #  #  #
 #  #  ####
 ## #### ##
### $ $ $ #
#  .....  #
#  $ $ $ ###
##       ##
 ####   ####
 # $$...$$#
 # $ ## #$#
 #  $    $#
 ## ## ## #
###      ###
#  $ $$  #
#   #  # #
#########