       ####
########  #
#  $ $ $  #
# $ # # $ #
###. . .###
  #$ # $ #
### ## ### ####
#  .   .  #  $ #
# $ #.# #$ # # #
## $ @ $    .  #
 #  # # #$ # # ##
 #  #  #   .  #
 ####### ###  #
       #     ##
       #######