#############################
# ...........................#
# .$.$.$.$.$.$.$.$.$.$.$.$.$ #
# $.$.$.$.$.$.$.$.$.$.$.$.$. #
# .$.$.$.$.$.$.$.$.$.$.$.$.$ #
# $.$.$.$.$.$.$.$.$.$.$.$.$. #
# .$.$.$.$.$.$.$.$.$.$.$.$.$ #
# $.$.$.$.$.$.$.$.$.$.$.$.$. #
# .$.$.$.$.$.$.$.$.$.$.$.$.$ #
# $.$.$.$.$.$.$.$.$.$.$.$.$. #
# . .$.$.$.$.$.$.$.$.$.$.$ . #
# $.$.$.$.$.$.$@$.$.$