           ########
           #  #   #
           #    # #
           ##  @# #
            #    ##
            #  # $
            ## #.#
           ## #.##
           #  #  #
           # # $ #
           # .# ##
          ##.# # #
          # $ # #
     #####.### # #
     #  $  $    ##
     # # #### #  #
     #    # # #$ #
     # ## # # #.##
     # #  #  #.##
     # # $ # #  #
     # ## # #   #
     #.## # #####.#
    ##. # # #     #
    # $  $    # # #
    #  # #### #   #
    # $# # #    # #
    ##. # # ##  # #
    ##.###.# ######
    #  # $ # #
    # $ #   $#
    ## #### # #
     # #    #@##
     #   # #  #
     ########  #