 #####
 #   #
## # ####
#    #  #
# #  $  #
# # #.####
#  $ @ #
##  #.#
 #### #
    # #
    ###