     #######
    ##     #
    #  # # #
    #  $  ##
#####.##$ #
#   $. #  #
#  $..@####
## #.## $ #
 #  #  $  #
 # # #  # #
 #     ## #
 #######  #
       #  #
 ## ####.##
 #  $  ....#
 #  $##.#####
 ##   # $   #
  #####    ##
      ######