##################
#                #
# ..  ..  ..  .. #
# $ $$ $ $$ $ $$ #
##$####$####$####$
# $ $$ $ $$ $ $$ #
# ..  ..  ..  .. #
#                #
# ..  ..  ..  .. #
# $ $$ $ $$ $ $$ #
##$####$####$####$
# $ $$ $ $$ $ $$ #
# ..  ..  ..  .. #
#                #
# ..  ..  ..  .. #
# $ $$ $ $$ $ $$ #
# @  ##   ##     #
##################