    #####
    #   #
    #   #
    #   #
    #   #####
    #     @ #
    #   # # #####
##### ### ###   #
#     $ $       #
#   # # # #   # #####
## ### .$. ## ## $  #
 #  .# ..$. #  # $  #
 # # ## .$.      $  #
 #    # # # # # $  ##
 ####   #   #   ####
    ##### #######
        # $  $ #
        #       #
        #   #####
        ### #  #
         ##   @#
        #  #   #
        #  #####
        ####
        #  #
        #..#
        #  #
        #####
        #  #
        #  #
        ### #
         #  #
         #$ #
         #  #
         #  #
         ####