     #######
     #  #  #
######$ $ $ ######
#  #  .. ..  #  #
# $   .. ..     #
##$###+   +###$##
# $   .. ..     #
#  #  .. ..  #  #
######$ $ $ ######
     #  #  #
     #######
     #  #
######$ ######
#  #  . .  #  #
# $      $    #
##$###+ +##$###
# $      $    #
#  #  . .  #  #
#####$ ######
    #  #
    ####