################################
#                              #
# .$    .$    .$    .$    .$   #
# $.$  $.$  $.$  $.$  $.$  $.  #
#.$.$ $.$ $.$ $.$ $.$ $.$ $.$ #
# $.$.$.$.$.$.$.$.$.$.$.$.$.$. #
#.$ $.$ $.$ $.$ $.$ $.$ $.$.$ #
# $.$  $.$  $.$  $.$  $.$  $.  #
#    .$    .$    .$    .$    . #
#.  $.$  $.$  $.$  $.$  $.$  $.#
# $.$.$.$.$.$.$.$.$.$.$.$.$.$ #
#.$ $.$ $.$ $.$ $.$ $.$ $.$.$ #
# $.  $.$  $.$  $.$  $.$  $.$. #
#   .$    .$    .$    .$      @#
#                              #
# .$    .$    .$    .$    .$   #
# $.$  $.$  $.$  $.$  $.$  $.  #
#.$.$ $.$ $.$ $.$ $.$ $.$ $.$ #
# $.$.$.$.$.$.$.$.$.$.$.$.$.$. #
#.$ $.$ $.$ $.$ $.$ $.$ $.$.$ #
# $.$  $.$  $.$  $.$  $.$  $.  #
#    .$    .$    .$    .$    . #
################################