 
    #####
    #   #
    #   ####
   ##  $.$ #
  ##  $.$  #
  # .$.$. ##
 ## .  .@##
## .$.$. #
#  $.$  ##
# $.$  ##
####   #
   #   #
   #####