  #############
  #     #     #
### ###.#.### ###
# $ $ #.#.# $ $ #
#  $  #.#.#  $  #
# $ $ #.#.# $ $ #
####  #.#.###  ##
   #    #      #
   ###     #####
     ###@###
 #####     ####
 #      #     #
##  ###.#.##  ###
# $ $ #.#.# $ $ #
#  $  #.#.#  $  #
# $ $ #.#.# $ $ #
### ###.#.### ###
  #     #     #
  #############