#############
#  .  #  .  #
# $   #   $ #
####$.#.$####
 ###     ###
 #         #
 # $ $.$ $ #
 ####...####
    # @ #
 ####...####
 # $ $.$ $ #
 #         #
 ###     ###
####$.#.$####
# $   #   $ #
#  .  #  .  #
#############