  ######
 ## #  ###
## #   # ##
# #   $.# #
##  $ $.# #
# #####. ##
#     $. @#
#     $. ####
### # # # # ###
  #### .$     #
    #  .$     #
    ## .##### #
    # #.$ $  ##
    # #.$   # #
    ## #   # ##
     ###  # ##
       ######