 ###################
##        .        ##
#  ####### #######  #
# # . . . . . . . # #
# #$ $ $ $ $ $ $ $# #
# # .#.#.#.#.#.#. # #
# #$ $ $ $ $ $ $ $# #
# # .#.#.#.#.#.#. # #
# #$ $ $ $$$ $ $ $# #
# # .#.#.#.#.#.#. # #
#  $ $ $ $@$ $ $ $  #
# # .#.#.#.#.#.#. # #
# #$ $ $ $$$ $ $ $# #
# # .#.#.#.#.#.#. # #
# #$ $ $ $ $ $ $ $# #
# # .#.#.#.#.#.#. # #
# #$ $ $ $ $ $ $ $# #
# # . . . . . . . # #
#  ####### #######  #
##        .        ##
 ###################