                    ####
              #######  #
              #      $ ##
    ########  # ..## $  #
           ## ##.#  #   #
   #######     #.# $ $###
 ###     #######.#  # ##
 #   ##    #   $.  $$  #
 # ##  #.# #@# #.#  ## #
 #  $$  .$   #    ##   #
 ## #  #.#######     ###
###$ $ #.#     #######
#   #  #.## ##
#  $ ##.. #  ########
## $      #
 #  #######
 ####