           ####
      #### #  #
      #  ###  #
      #  $    #
      #  #  # ####
##### # #  ####  #
#   ### ####  $  #
# $  $  $  #   #  #
#  #   $   #   #  #
#  #  #  # #  ##
#  ####  # ####
##    ####
 #####
 # @ #
 #   #
 #####