            ####
  ###########  ####
  #   #     # $  #
  # # $  $ $#  # #
  #  $  # $  # # #
  ##$#  $   $ $  #
###  # $ #$  #   #
#    $  #   #$ ###
# # $  $# $  #  #
# #  $  #  # $  #
#  $ #$   $  #  #
##  #  $  $#$ ###
 ####  $  $  #
    # $  #$ #
    #  $  # #
    # # $  #
    #  $ # #
    #  @  #
    ######