    ####
    #  #
    #  #
    #  #
    #  #
    #  #
    #  #
    #  #
    #  #
    #  #
    #  #
    #  #
    #  #
    #  #
    #  #
    #  #
    #  #
    #  #
    #  #
    #  #
    #  #
    #  #
  ###  ###
  #  $  #
###.$.$.###
#  $ $ $  #
# .$.$.$. #
#  $.$.$  #
# $.$.$.$ #
#  $.$.$  #
# $.$.$.$ #
#  $.$.$  #
# $.$.$.$ #
#  $.$.$  #
# $.$.$.$ #
#  $.$.$  #
# $.$.$.$ #
#  $.$.$  #
# $.$.$.$ #
#  $.$.$  #
# $.$.$.$ #
#  $.$.$  #
# $.$.$.$ #
#  $.$.$  #
# $.@.$.$ #
#  $.$.$  #
###.$.$.###
  #  $  #
  ###  ###