  #####
  #   #
### # ##### #####
#   # #   ###   #
# $  $ .$  #  $  #
## #$ $ $ # $ $ ##
 #  $.$.$.$.$.$  #
## $ $ $ #$ $ $ ##
#  $  #  # .$  $ #
#   ###   ### #  #
##### ##### #   #
#   # #   $  $  ##
# $  $  # $ $ $ ##
## $ $ $ # $ $  #
 #  $.$.$.$.$  ##
## $ $ $ # $ $ ##
#  $  #  # .$  $ #
#   ###   ### #  #
#  $  #  # $ $ ##
## $ $ $ # $  $ #
 #  $.$.$.$.$.$  #
## $ $ $ # $ $ ##
#  $  $ .$  # $ ##
#   # ###   #   #
##### ##### # ###
  #   #   # $  #
  ##### # # #####
        #   #
        #####