           #####
           #   #
           # $ #
           # $ #
         ### $ ###
         #  $ $  #
         #  $ $  #
         ## $ $ ##
         #  $ $  #
         #  $ $  ##
########## $ $ ####
#   ##   #  $ $    #
# . . . . . $  #   #
#   ##   #  $ ######
########## $  #
         #  $ ##
         ## $  #
          # $ $ #
          # $ $ #
          ### $ ###
            # @ #
            #####