    #####
    #   #
    #   #
    #   #####
    ####   #
##### $ $  #
#   #.$.$.###
#   #.$.$.$ #
#   #.$.$.  #
### #.$.$.$ #
  #  $.@.$  #
  # $.$.$.# #
  #  $.#.$  #
  ### #.$.$ #
    #  .$.  #
    #### ####
      #   #
      #####