    #####
    #   #
    # $ #
    #  $#
    ##$##
  #### ####
  #  . .  #
  #$ .$.  #
### $.$.$ #
#  .$. # ##
#  . . #  #
########  #
       #$ #
     ####  #
     #  ####
     #   #
     #####