   #####
   #   #
   # # ####
   # $ $ #
 ### . . ###
##  .@. .  ##
#  . . . .  #
#  . .$. .  #
#  . . . .  #
##  . . .  ##
 ### .$. ###
   # $ $ #
   # #  ##
   #   #
   #####
     #
     #
     #
     #
     #
     #
     #
     #
     #
     #
     #
     #
     #
     #
     #
     #
     #
     #