  #####
  #   #
### # ####
#  $  $  #
#  .$ $. #
## $.$.$##
 # .$ $.#
## $.$.$##
# .$ $. #
#  $.$  #
# .$ $. #
#  $.$  #
## $.$.$##
 # .$ $.#
## $.$.$##
#  @  # #
### #  $ #
  #   #  #
  #####  #
       # #
       ###