      #####
      #   ####
      #  $   #
      #  $.$ #
      ## $.$ #
##### # $.$ #
#   # # $.$###
#   # # $.$   #
#  $  # $.$  @#
##   $ $.$  $ #
 ####   # $  #
    #####   ##
        #####