           #####
           #   #
           # # ####
           # $ $  #
           # #.#  #
           # $ $  #
           ## $ $ #
            # # # #####
          #### $ $ $  #
          #  # $ $ $  #
          #  # #.# #  #
          #  # $ $ $  #
          ## # $ $ ####
           #  # # # #
         ##### $ $ # #
         #  # $ $ # #
         #  # #.# # #
         #  # $ $ $ ##
         ## # $ $ $  #
          #  # $ $ $ ##
          #  # #.# #  #
          #  # $ $ $  #
          ## # $ $ #  #
           #  # $ $ ####
           #  # # # #
           # #  .$ # #
           #  $ $ $  #
           #  # # # #
           #### $ # #
              #   # #
              ##### #
                #   #
                #####