           #### #
          ##  ### #
         ## $$ $  #
         #  $  $  #
         # $ $ $  #
         #  $  $ ##
         # $ $ $ #
         #  $  $ #
         # $ $ $ #
         #  $  $ #
         # $ $ $ #
         #  $  $ #
         # $ $ $ #
         #  $  $ #
         # $ $ $ #
         #  $  $ #
         # $ $ $ #
         #  $  $ #
         # $ $ $ #
#####    #  $  $ #
#  .###### $ $ $ #
#    @##  #  $  $ #
#       ## $ $ $ #
#       ##  $  $  #
#       ## $ $ $  #
#        #  $  $  #
#        # $ $ $  #
#        #  $  $ ##
#        # $ $ $ #
#        #  $  $ #
#        #      .#
#################