    #####
    #   #
    #   #
#####   #####
#  $  ## #  #
# $.$    $  #
#  .$.$.$  ##
### $  $  #
  #  ##  ##
  #     ##
  #######