       ####
       #  ########
       # $  $ $ $ #
       # .#.#.#.#.#
       # $  $ $ $ #
       ##.###.###.#
 ####### $  $ $ #####
 #  #  #.#.#.#.#.#  #
 #  $  $  $ $ $  $  #
 # .#.#.#.#.#.#.#. #
 #  $  $  $ $ $  $  #
 #.###.###.#.###.#.#
## $  $ $ $ # $  $ ##
#.#.#.#.#.#.#.#.#.##
#  $  $ $ $  $  $  #
###.###.#.#.#.###.#
  #  #  $ $ $  #  #
  ##### #.# # #####
      # $  @  $
      ####   #
          ####