    #####
    #   #
    # $ #
    #  $#
    #$  #
    # $ #
#####  #
# .$. #
#  @  #
# .$. #
#####  #
    # $ #
    # $ #
    # $ #
    # $ #
    # $ #
    # $ #
    # $ #
    #   #
    #####