    ####
    #  #
    #  #
    #  #
   ##  ###
  ##      #
  #   $ . #
### $ .$$.#
#   $. .@.#
# $#.$.$  #
#   . $   #
#####  ####