       ####
       #  #
 #######  #
 #  $ $ $ #
 # .$.$.$.#
### $.$.$ ####
#  .$.$.$. $ #
# # $.$.$ #  #
#  $ $ $  #  #
#  #  #   #  #
####  #### ####
   ####  #
   #  #  #
   #  ####