      ####
      #  #
      #  #
      #$ #
      #  #
      #  #
      #  #
      #  ####
      #  #  #
######$ #  #
# $   $    #
# .#.#.#.#.#
#    $   $ #
###### # $##
      #  # #
      #  # #
      #  # #
      #### #