###############################
# #   #   #   #   #   #   #   ##
# # # # # # # # # # # # # # # ##
# $ $ $ $ $ $ $ $ $ $ $ $ $ $ #
## $ $ $ $ $ $ $ $ $ $ $ $ $ $#
 ## $ $ $ $ $ $ $ $ $ $ $ $ $ #
 # $ $ $ $ $ $ $ $ $ $ $ $ $ $ #
 # $ $ $ $ $ $ $ $ $ $ $ $ $ $ #
 # $ $ $ $ $ $ $ $ $ $ $ $ $ $ #
 # $ $ $ $ $ $ $ $ $ $