       #######
       #  #  #
       # $.$ #
       ## $ ##
        #  . #
        # # ####
######### # #  #
#  #  #  # #   #
# $.$ $.$ #  # #
## $ .$.$ #$ # #
 # .  .  .  $  #
 # # #$ $.$ ##
 #   #  #  # #
 #  #   # # ########
 # #  #  #  #  #  # #
#  #   #  #  # $.$ $#
#  #  #  # ### # #  #
# #  # #   # $.$ $.$#
#  # # $# $ ## # $ ##
#   $  .  .  #  .  @#
###########  ##    #
          ####    #
             ######