     #####
     #   #
     # $ ###
     #  $  ####
   ### $  $ $ #
   #  $  $ #  #
   # $  $  ####
####  $  $  #
#   $  $ $ ###
#  $  $  #   #
#### $  $  $ #
   #  $  $  ###
   # $  $ $ #
   ### $  $ #
     # $  $  ####
     #  $  $ $ #
     # $  $  $  #
     #  $  $ $ ###
     #### $  $  #
         # $  $ #
         #  $  $  ###
         # $  $ $ #
         #   $  $  #
         ### $  $  #
           # $  $  #
           #  $  $  #
           ### $  $ #
             # $  $ #
             #  $  @#
             #####  #
                   ##