       ####
       #  #
       #  #
       #  #
       #  #
       #  #
    #####  ####
    #   $$$ $ #
    # #  $ $  #
    # $ $.$.$ #
    #  $ $ $  #
    #   $.$ $ #
    #  $ $ $  #
    # $.$.$ $ #
    #  $ $ $  #
    # $ $.$.$ #
    #  $ $ $  #
    # $.$ $   #
    #  $ $  # #
    # $ $  #  #
    # $ $  # #
    ####  ####
       #  #
       #  #
       #  #
       #  #
       #  #
       #  #
       ####