     #####
     #   #
  ##### # #####
  #   # # #   #
##### # # # #####
#   # # # # #   #
# $ # # # # # $ #
# $ # # # # # $ #
# $ # # # # # $ #
# $ # # # # # $ #
# $ # # # # # $ #
# $ # # # # # $ #
#   # # # # #   #
##### # # # #####
  #   # #   #
  ##### @ #####
     #   #
     #####