     #######
     #     #
  #####.#   ####
  #   #.#####  #
### # #.#  $$  #
#   # #.#   #  #
# . # #.#  ##  #
#  $  $.$  #   #
# . # #.#  # # #
#  ## #.#  #   #
#   # #.#$ ##$##
###  $  #  @  #
  ###.# # #  ##
    # $  $  #
    #   #. #
    #####. #
        #   #
        #####
