          ####
         ##  #
        ## .$#
        #  $ #
        # #  #
        #  $ #
        # #  #
        #  $ #
        # #  #
        #  $ #
        # #  #
        #  $ #
        # #  #
        #  $ #
        #@ $ #
        # #  #
        #  $ #
        # #  #
        #  $ #
        ##  ##
         ####