    #####
    #   #
    #   #
    # $ ####
    # $ #  #
    #  $    #
    #  $ .  #
    ## $ .  #
##### $ .  #####
#   # $ .     #
#  $  $ .  #  #
#      .  #$ ##
#  #  .  $  $  #
####. $ # $  # #
   # . $ # $  $#
   # . $ # $   #
   # . $ #### $#
   # .         #
   # .  #### $##
   # . $    $  #
   # .  $  .   #
   ##  @  .  $ #
    #      $  $#
    #  #  . $  #
    #### $ . $ #
       # . $ . #
       # . $ . #
       # ####$ #
       #     # #
       ####### #
             # #
             ###