    ####
    #  ##
    #   #####
    #  $.$  #
#####.$ .$ #
#   # $ #  #
#  $  . .#####
# # $.#$ #
#  #  $  #
# #. .  $  #
# # $.@.$###
#   ####   #
#####  #####
    #  #
    ####