 #####
 #   #####
## # #   #
# $ $.$  #
#  $  .# ##
## ## #  #
 #    $ $#
 #  . $ $#
## #.  $ #
# $  $. $#
#  $.  # ##
## #  # ##
 # $ $    #
 # $.$ $  #
 #  .#  $ #
## #   # # ##
#   # # #   #
##### @ #####
     #####
