       ####
       #  #
 #######  ####
##  $  $    ##
#  #.#.#.#.#  #
# $ $ $ $ $ $ #
#  #.#.#.#.#  #
## $ $.$.$ $ ##
 ## #.#.#.# ##
  ## $.$.$ ##
  ## #.#.# ##
  ## $.$.$ ##
  ## #.#.# ##
  ## $.$.$ ##
 ## #.#.#.# ##
## $ $ $ $ $ ##
#  #.#.#.#.#  #
# $ $ $ $ $ $ #
#  #.#.#.#.#  #
##    $  $  ##
 ####  #######
    #  #
    ####