    #####
    #   #
    # $ ####
    #  $ $ #
    ##.$.$.#
##### $ $ #
#   # $ # ####
# . #  $    #
#  @#   #   #
#   #      ##
##### # ####
    #   #
    #####