        #####
        #   #
        # # #
        # $ #
        #$  #
        #   ######
        # # #    #
   ######. .$. . #
   #    #    # #$#
   # ## # $ #    #
   #    #    #####
   ## $ # $ #
####  # # # #
#   # #  $  #
#  $  # # # #
# # # #    ##
#    $ # $  #
# # # # # # ######
#  $  # #      ...#
# # # # # # # # @ #
#   # # # # # # # #
#####             #
    # # # # # # # #
    # # # # # # # #
    # # # # # # # #
    # # # # # # # #
    #   # # # # # #
    #####       ##