    #####
    #   #
    #   ########
    #  $  $ $ .#
  ### $  $  $  #####
  #  $ $  $  $  $  #
### $  $  $  $  $  #
#   $  $  $  $  $  #
# .  $  $  $  $  $ #
#####  $  $  $  $  #
    # . $  $  $  $ #
    #  ######   #  #
    #      #### #  #
    #       @ $  $  #
    #      ##   #  #
    ########    #  #
           ####   #
              #####