  #####
###   ###
#  # #  #
# $.$.$ #
## .$ $.#
 #.$ .$ ##
 # $.#.$ #
## $.$.$ ##
# $.#.#.$#
# $.$.$.$#
# $.#.#.$#
# $.$.$.$#
## $.$.$ ##
 # $.#.$ #
 #.$ .$ ##
## .$ $.#
# @.$.$ #
#  # #  #
###   ###
  #####