      #####
      #   #
      #   #
      # # ####
      # # #  #
      # #    $###
      # # ##$.$ #
      # # #     #
      # # #  #$###
      # # #### #
      # #      #
      # #  #####
      # #  #
      # #  #
      # ####
      # #
      # #
      # #
      # #
      # #
      # #
      # #
      # #
      # #
      # #
      # #
      # #
      # #
      # #
      # #
      # #
      #@#
      ###