    #####
    #   ####
    # $ $  #
    # .#$. #
    #  . . ######
  ### # # #     #
  #   # # #  #$###
  # # # # # $ $  #
  #  .  .  # $ $ #
### # # # # $ .  #
#   # # #  # $ $# #####
#  $  $ #  #     #    #
# @ ######       ######
#####