    #####
    #   #####
    #   $ $ #
##### $  # #
#   # $ .  #
#  $  #.#. #
# # #  .@.$#####
#  .#.#. #  #
# $ .  $ #  #
# # #  $ #####
#  #  $ #
#####   #
    #   #
    #####