       ####
       #  #
       #  #
#######  #######
##  $ $    $  ##
#   . .    . . #
#   . .    . . #
## $ $  ## $ $ ##
 # . .  ## . . #
 # . . @## . . #
 ## $ $ ## $ $ ##
# . . ## . .  #
# . .  ## . .  #
## $ $ ## $ $ ##
#######  #######
       #  #
       #  #
       ####