   #####
  ##   #
  #  # # ####
  # $ $ $ $ #
  #  . . .  #
  ##$ $ $ $ #
### # . . .  #
#   $ $ $ $ ##
#  # . . . $ #
## $ $ $ $  #
 #  . . . $ ##
 # $ $ $ $  #
 #  . . . # ##
 ## $ $ $ $  #
  #  . . . # ###
  # $ $ $ $   #
  ##  . . . $ #
   # $ $ $ $  ##
   #  . . .  # ####
   # $ $ $ $ # #
   #### ####   #
       #  @     #
       ############