############################
#                          #
# $.$.$.$.$.$.$.$.$.$.$.$  #
# $.$.$.$.$.$.$.$.$.$.$.$  #
#  .$.$.$.$.$.$.$.$.$.$.$. #
#  .$.$.$.$.$.$.$.$.$.$.$. #
# $.$.$.$.$.$.$.$.$.$.$.$  #
# $.$.$.$.$.$.$.$.$.$.$.$  #
#  .$.$.$.$.$.$.$.$.$.$.$. #
#  .$.$.$.$.$.$.$.$.$.$.$. #
# $.$.$.$.$.$.$.$.$.$.$.$  #
# $.$.$.$.$.$.$.$.$.$.$.$  #
#  .$.$.$.$.$.$.$.$.$