            #####
           ##   ##
          ##     ##
         ##       ##
        ##         ##
       ##           ##
      ##             ##
     ##               ##
    ##                 ##
   ##                   ##
  ##                     ##
 ##                       ##
##                         ##
#  .$.$.$.$.$.$.$.$.$.$.$  #
#  $.$.$.$.$.$.$.$.$.$.$.$  #
#  .$.$.$.$.$.$.$.$.$.$.$  #
#  $.$.$.$.$.$.$.$.$.$.$.$  #
#  .$.$.$.$.$.$.$.$.$.$.$  #
##                         ##
 ##                       ##
  ##                     ##
   ##                   ##
    ##                 ##
     ##               ##
      ##             ##
       ##           ##
        ##         ##
         ##       ##
          ##     ##
           ##   ##
            #####