 #####
 #   #####
 #  $  $ ####
 #  .$.$.$ #
 # $ $ $ $ #
###.$.$.$. #
# $ $ $ $  #
# $.@.$.$  #
#  $ $ $ $ #
# .$.$.$.###
# $ $ $ $ #
# $..$.$. #
#  $ $ $  #
###.$.$.$ #
 # $ $ $ $ #
 # $. .$.$ #
 #### $  $ #
    #####  