      ########
     ##  #   ##
    ##   $    ##
   ##  $.#.$  ##
  ##  $.$@$.  ##
 ##  $.#.$  ##
##  $.$    ##
#  $.$    ##
#  $.#.$  ##
#   $.$  ##
#    $   ##
##   #  ##
 ###   ##
  ###   ##
   ###  ##
    ######