    #####
    #   #
    #   ####
  ###     #
  #  $.$  #
### #.# ###
#   #.# #
# $  .  #
#   #@  #
#####   #
    #   #
    #####