       ####
       #  #
#######  #####
# $  $  #    #
#  #.## # $  #
# $ .   #  $ #
## ##.## #  ##
 # .   . # $ #
 # #.## ## ##
 # $  $  # #
 #    # $ # ####
 #####  #  #   #
     #  $  $ $ #
     #  #. . . #
     #    @    #
     ############