    ######
    ##  ##
    #    #
    # .$ #
  ### $.$ ###
  ##  $  ##
### $.$.$ ###
##  $.$.$  ##
# .$.$.$.$. #
# $.$.$.$.$ #
# .$.$.$.$. #
##  $.$.$  ##
### $.$.$ ###
  ##  $  ##
  ### $.$ ###
    # .$ #
    #    #
    ##  ##
    ######