      #####
      #   #
      # $ #
      # . #
      #  $#
      ##.####  ####
#######.###  ##  #
#     #.##  $  $  #
# $ $ $ ## $   $  #
#  $    #  $  $ $ #
#   ####   ####  @#
#####      #
    #      #
    #      #
    #      #
    ########