     #####
     #   #
     # $ ######
  ##### $ $ $ #
  #   # $ $   #
  # #  $ $  # #####
  # #  $ $  # #   #
#####  $ $  # # ###
#   #  $ $  # # #
# # #  $ $  # # #
# # ######  # # #
# #        ## # #####
# #  ######    #     #
# # ##    # #### #####
# # ##    # #  # #
# # #     # #  # #
# # #  ####  $   #
# # #   @# #  #####
# # #####     #
#     #########
######