    #####
    #   #
    #   ########
    # $  $ $ $ #
    #  . . . . #
    ##. . . .  #
#####  . . .  #####
#   #  . . .     #
#  $   . . . #####
# $$$  . . . #
#  $  $ $ $ #
#    @     #
############