      #########    #########
      #   #   #    #   #   #
      # $.$ $ #    # $.$ $ #
      #  $.$  #    #  $.$  #
      # $.$.$ #    # $.$.$ #
      ##  $.$ #    ##  $.$ #
     ### $.$ ##  ### $.$  ##
     #  $.$  #### #  $.$.$ #
     # $.$.$ #  ## $.$.$ $ #
     # $.$ $ #  ## $.$ $.$ #
     #   #   #  ##   #   # #
     #########  ##   ##### #
           ##   ## # #    ##
          ##  # ## # #  #  #
          #  # #  # # #  #  #
          #  # #  # # #  #  #
          #  # #  # # #  #  #
          #    #  # # #  #  #
          #  # #  # # #  #  #
          #  # #  # # #  #  #
          #  # #  # # #  #  #
          #  # #  # # #  #  #
          #  # #  # # #  #  #
          #  # #  # # #  #  #
          #  # #  # # #  #  #
          #  # #  # # #  #  #
          #  # #  # # #  #  #
          #  # #  # # #  #  #
          #  # #  # # #  #  #
          #  # #  # # #  #  #
          #  # #  # # #  #  #
          #  # #  # # #  #  #
          #  # #  # # #  #  #
          #  # #  # # #  #  #
          #  # #  # # #  #  #
          #  # #  # # #  #  #
          #  # #  # # #  #  #
          #  # #  # # #  #  #
          #  # #  # # #  #  #
          #  # #  # # #  #  #
          #  # #  # # #  #  #
          #  # #  # # #  #  #
          #  # #  # # #  #  #
          #  # #  # # #  #  #
          #  # #  # # #