   ####
   #@ #
  ##  #
  # .$#
  #$. #
###..$###
#  ..$  #
#   $ $ #
#########
 ####  ##
 #  $  # 
 # $ $ # 
###..$###
#  ..$ #
#   .$ #
#####. #
    # $#
    #  #
    ####