#############################
###  #  ##  #  #  #  #  #  ##
##   #   ###  #  #  #  #   ###
#    # $ # ##     #  # # $ $  #
#   ##   .  #.######    ## #  #
## #  .# ... @ ## #  #  #  $ ##
#    #. # ...   ###  #  # $  # #
#   ## ####### #  ## #  #  #  #
###  #.  #  #  #   ###   ##   #
#### #.. #  #  # $  ##$ $ #   #
###  #.## #  #  #  #  #   #   #
#    #.   ##    #  #  #####  ##
# $  #. # ## #  #  #  #   #  #
## $  .## ###   #  #  #   # ##
###   #  # ## #   ##   #  ## #
###  ##   #  #### #  #####  # #
### #  #  #   ##  ####   ##  #
##  #  #  #  ## $  #  # $  #  #
#  #  #  ## #  $  ###  # $ #  #
#  #  #  ###   $  ###   ##  ###
##  #  #   # $ $ #  #  #  #  ##
###  #  #  #  $  #  #  #  #  #
###  #  ##    #  #  #  #  # ##
###  ##  #  #  #  #  #  #  ###
###  #  ##  #  #  #  #  #  ##
#############################