      ####
  #####   ###
  #         #
  # $ $.$.$ #
  ## . . . ##
 ## $.$@$.# #
 # . . . #  #
 # $.$.$ ## #
 #         #
 ###   #####
   ####