  #####
  #  ####
 ##$   # ###
## .$  #   ##
#  .$     $ ##
# #   ####   #
# #  ##  ##$ #
#  ##.. .  # ###
## # $  #    $ #
## #   $  #    #
#  ### ####  # #
# #  #  #  ##  #
# #    $   $  ##
# #  ## ##  $ ##
# ####  @  ####
#   ####    #
#####   # ##
    ##  $  #
   ## $  ###
    # $   # ##
    #   $.. ##
    ##   $  # 
   ## $  #  #
    ### ####
      #  ####
      #####