  #######
  #     #    #######
  #     #    #     ######
  #     ###### $ $ $ $ #
  #######  #   . . . . #
         # #   # # # # ####
         # ########      #
       ###          # # #
  ######   #### #    #   #
  #.$  .$###   ########   #
  #.. @ ..# #           ###
  #.$  .$.# #   #########
  #.$  $.#  #####   #
  ######         ####
       #  #####  #
  ###### #   #####
  #      #
  #   #  ########
  #  ##  #      #
  ##  #    $$  ##
   #  #  $$  $#
   ####  #   ##
      # ##  ##
     ###  $##
     #  $$  #
     #      #
     ########