 
  ####
 ##  ###
 #  $  ##
 #      #
 # .$$.#
 ###  ####
   #  #  #
 ###$  $  #
##      . #
#  $$$.@. #
# #  #   ##
#      #  #
##  ###  ##
 ####  ####
    ##  #
    ##  #
   ##    ###
  ## $$ $ ##
 ##  #.#.  #
##  #.$.$. #
#  ##.#.#  #
#   $ $    ##
###  #  #  #
  ####  ###
     ####