  #####
  #   #####
 ##  $    #
 # ..#.#  #
 # ..$. $ #
 #  #.#..$#
 ##  $.$ ##
###@ ###  #
# $.$  #  #
# ..#.$ ## 
#  $.$..# 
## $ #..# 
 #  ##$  ##
 #  ..#   #
 #### #  ##
    # $.$ #
  ##..$..# 
  # $.# ##
  #    $ ##
  #####   #
     # .. #
     ######