###############################
#  ...  ...  ...  ...  ...  #. #
# #.## #.## #.## #.## #.## #.##
# $ $ $ $ $ $ $ $ $ $ $ $ $ $ #
# $ .$ $ .$ $ .$ $ .$ $ .$ $ .#
# @$   $   $   $   $   $   $  #
# $ .$ $ .$ $ .$ $ .$ $ .$ $ .#
# $ $ $ $ $ $ $ $ $ $ $ $ $ $ #
# #.## #.## #.## #.## #.## #.##
#  ...  ...  ...  ...  ...  #. #
# #.## #.## #.## #.## #.## #.##
# $ $ $ $ $ $ $ $ $ $ $ $ $ $ #
# $ .$ $ .$ $ .$ $ .$ $ .$ $ .#
#  ...  ...  ...  ...  ...  #. #
# $ $ $ $ $ $ $ $ $ $ $ $ $ $ #
# #.## #.## #.## #.## #.## #.##
# $ $ $ $ $ $ $ $ $ $ $ $ $ $ #
# $ .$ $ .$ $ .$ $ .$ $ .$ $ .#
#  ...  ...  ...  ...  ...  #. #
# $ $ $ $ $ $ $ $ $ $ $ $ $ $ #
# #.## #.## #.## #.## #.## #.##
# $ $ $ $ $ $ $ $ $ $ $ $ $ $ #
# $ .$ $ .$ $ .$ $ .$ $ .$ $ .#
#  ...  ...  ...  ...  ...  #. #
# $ $ $ $ $ $ $ $ $