  ####
  #  #####
###    @#
# $ $.$ #
# $ $.$ #
#  ##. ##
##  ....#
 # #*####  
 #  * ##
 #....  ##
##.## $  #
# ....  ##
# #.##  ##
# # $ $# 
# #   ###
#####  # 
    #  #
    ####