  ###################
  #        .        #
  # # ####   #### # #
  # #   ##   ##   # #
  # $$$ ## . ## $$$ #
 ##  $.$ #   #.$. $  ##
 #  $.$  # $ #  $.$  #
 #  $  $## $ ##$  $  #
 #     #     #     #
 ####### @ #######
 #     #     #     #
 #  $  $## $ ##$  $  #
 #  $.$  # $ #  $.$  #
 ##  $.$ #   #.$. $  ##
  # $$$ ## . ## $$$ #
  # $   ##   ##   $ #
  # # ####   #### # #
  #        .        #
  ###################