  #### ####
 ##  ###  ##
 #   ###   #
 # $  #  $ #
  $ # #   #
### # #  ###
####. . .####
### # #  ###
  $ # # $  
 #  $.$.$.  #
 # # # # # #
 #  $.$.$  #
 # # #.# # #
 ## $ @ $ ##
 # # #.# # #
 #  $.$.$  #
 # # # # # #
 #  $.$.$.  #
 # # # # # #
 #  $.$.$.  #
 ## # # # ##
 ###... ...###
 ## # # # ##
 #   $ $   #
 # ### ### #
 #   # #   #
 #$  # #  $#
 #   ###   #
 ##  ###  ##
  #### ####