       #######
       #  #  #
       #    #    #######
     #####  ######  #  #
  ####   ####     $#   #
 ##      #   #  #  $   #
 #     #   $ #$ ## $  ##
 #    ## $ #. .#  $  $ #
##    $  . . . ##  ###   ####
#   ## # # $ .  ###.######  #
#  #  ## ##$# .  # .      $ #
# #   $     $## #$.$ #  #  ##
#  $  #  #  $   .   . # $  #
##  $ #  ###  .$ #. ##  # #
 # $  ##  ##   .  $    ##
 #  ###   #######  #####  #
 #   #  $     #   ####  ####
 ##  # $  .# ##. . # $    ##
  #  #  ### ##. .#  #  #   #
  ######. ##$## ##    #####
       #    $   #
       ### @ ###
         #    #
         ######