#################################
###  #  #  #  #  #  #  #  #  ###
##   #   #  #  #  #  #  #   ##
#   ### ### ### ### ### ###   #
# ###   ###   ###   ###   ### #
#=# # ### # ### # ### # ### # =#
#   #   ###   ###   ###   #   #
# ### # ### # ### # ### # ### #
#   ###   ###   ###   ###   # #
# ### # ### # ### # ### # ### #
#   ###   #   ###   #   ###   #
# ### # ### # ### # ### # ### #
#   ###   ###   @ ###   ###   #
# ### # ### # ### # ### # ### #
#   ###   #   ###   #   ###   #
# ### # ### # ### # ### # ### #
#   #   ###   ###   ###   #   #
# ### # ### # ### # ### # ### #
#   ###   ###   ###   ###   # #
# ### # ### # ### # ### # ### #
#   ###   ###   ###   ###   # #
#   #   #  ###  #  ###  #   #  #
##   #  #  #  #  #  #  #   ## #
###  #  #  #  #  #  #  #  ### #
#################################