  #######
  #     #    #######
  #     ######     #
  #. . . $ . . .  .#
  # $$$#$ $ $$$# # #
### # # $ # # # # #
#  # # #$$$# # #   #
#   . $ $@$ . .   ##
#   ## ###### #####
###   . . .  .   #
  #.###### #######
  # $   . . . .   #
  ### # $$$$ # # ##
   ## # # #  # # #
    # # # #$$$# # #
    #   # # #   # #
   ##   . . .   # #
   #. ## ######   #
   # ###### ##. .#
   # #  . . .   $ #
 ###$   . . .  .  #
 #  ###### ######.#
##   #   $ $ $   .#
# . ## ###### ##  #
#   .  .   . .  .  #
#  ## ## ##### ##.#
#.##  #### #  # ####
# # # #  # # $ $ $ #
# # $ # $$   . . . #
#   @ #  ######### #
######