       #### ### ### ####
       #  ### ### ###  #
     ######              ####
     ##  #                # ##
      # $    $        $      #
      ###. .#. .      .#. .###
      ### ###@###  ### ### ###
      #.  .#...#.  #...#.  .#
      # ##      ##      ## #
     ## # $    $ ## $    $ # ##
     #  .###. .#  #. .###.  .#
     ## #      ## #      # ##
     #  ##                ## #
     #    ####      ####    #
     #########      #########
          ##        ##
         # ##      ## #
         #  #      #  #
        ##  ########  ##
        #   ###  ###   #
        #   ###  ###   #
       ##  ##      ##  ##
       #   #        #   #
       # ##          ## #
      ## #            # ##
      #  ####    ####  #
      #      ####      #
     ##      ####      ##
     #                  #
     ####            ####
     #  ###        ###  #
     #    ##########    #
     ##   ##    ##   ##
      #####      #####