   ############
   #          #
   #  ######### ####
   ##    $       # ###
#### ###  ###### . .#
#      #  ##  ## ... #
#  ####  ## $ #####  #
# ##   #  #  #### ## #
## $   ###$##  #    # #
#  ### #  #  $ #  #   #
# #   ######## ## # ##
# # ##       $  ## # #
# #. $.$.. ##  ###  #
# # ## $.$######  ##
#   .@. . #     ###
##### $  ########
    #          #
    ############