 ######       ####
##    #       #  #
#  $  #       #  #
#  # #########  # ######
#### #    $      $     #
#####  $ #   #### #     #
#   #$  $####    # #  # #
#      $    #    .#$  #.#
#   ###### ##. . # #  #.#
# ##  $ $  # ##.## #  #.#
# #  $ $ $ .    .  #  #.#
# # $ $ $!# # ##. #  #.#
#  $ $ $  .  # ##. #  #.#
# #!$ $ $ $ # ##. #  #.#
#    #    $      #  #.##
#########    ####  #  #
         ####       ##
           #       ##
         ####      #
         #  ########
         #  $    ###
         #      # ##
         #  ####   #
         ####  #  #
            #  #  #
            # $$  #
            #  @  #
            ########