           #####
           #   #######
         ###   #     #
         #  #####   ###
  #######      #####
###      $   ####
#   ####  ##$ ##
#      #.$ $. #
#     ##...  #  ####
##      . # # ######
 ##  ##   @#
  ####  ####
     ####