     ######
     #    #
      $$$ #
###  $# .###
# ## #.$   #
# #  ... # #
# # $.$@$ # #
# #  ... # #
# #   $ # ##
# #### #. ##
#      # ###
## ####   ##
 ###  ##$  #
   #  #.#  #
   #    $  #
   ###  # ##
    #######
      #  #
      #$.#
      ####