  #######
  #     # #######
 ## ### # #     #
 # ## $ ### ### $##
 # #  $   #  ## ...#
 # # $ #.#  #  ....#
 # #  $  # # ## ...#
## ### # #    ##$ ##
#     # #######  #
# #####
# #
# ###########
#       #   ####
######### #### #
#   #   # #### #
## ###$##$    #
## ###...## # #
## ......# # ##
# ......$  $ # #
# #. #...## ###$##
# ##  # ### ##$ ##
# ##$ ### $##  # #
# #.#### #   $  # #
# # #### #########
#   #
#####