         #####
         #   #
      ####   ###
      # $$$   #
      # $ #$  #
      ## .# ###
      ## . $##
      #  # #.##
      #$   $ .#
      # ### .##
    ###  #####
    #   ##
#####  ##
#   #  ##
# $  $ ##
#. #. ##
#$ . ###
#   .#
### @#
  #  #
  ####
   #