 ######
 #   ###
## #   ## #####
#    #  ###   #
#  $ #      $ #
##### #   #####
   ## #..####
  ##  ....   #
  # $ ..#..$ #
  #  #. .##  #
  #$      #  #
  ## #### $ #
 ##  $     ##
 #  ## @#  #
## $  . . ##
#  #. . .# #
#  # ##   #
# $## #####
#.... ..  ##
#   ##. $  #
#####   #  #
     ######
