  #############################
###  #  #  #  #  #  #  #  #  ###
##   #  #  #  #  #  #  #  #   ##
#    #  #  #  #  #  #  #  #    #
# . .   . .   . .   . .   . .  #
# $ $ . $ $ . $ $ . $ $ . $ $ #
# $ $ . $ $ . $ $ . $ $ . $ $ #
# $ $                       $ #
# $ $ . $ $ . $ $ . $ $ . $ $ #
# $ $ . $ $ . $ $ . $ $ . $ $ #
#    #  #  #  #  #  #  #  #    #
#   #  #  #  #  #  #  #  #  #   #
###  #  #  #  #  #  #  #  #  ###
###############################