   
   ################        
  ## #       #   #       
 ##     #  #    ##      
 #   ##   ###  #  #     
 # ####. .#  ### #.      
 # ## # # #    ## #     
 #  $  $ # .##  #  #    
 #   ##    #### #  #     
 #    ##  ##  # ## #    
 # #  ##  #   . .# #     
 # ##  #. . #  #   #    
##  #  ###    # ####   
##    #  #. #### #     
#  #  ### #  . . #      
###    @    ####