#############################
###   ###   ###   ###   ####
##     #     #     #     ###
# .$.$# .$.$# .$.$# .$.$####
# $.$.# $.$.# $.$.# $.$.#####
# .$.$# .$.$# .$.$# .$.$####
##    ###   #     ###    ###
### # ### @ # ### ### # ###
##    ###   #     ###   ####
# .$.$# .$.$# .$.$# .$.$####
#    #     # ### #     #  ##
# .$.$# .$.$# .$.$# .$.$. .#
# $.$.# $.$.# $.$.# $.$.$. #
# .$.$# .$.$# .$.$# .$.$. .#
##    ###   #     ###   ####
### # ###   # ### ### # ###
##    ###   #     ###    ##
# .$.$# .$.$# .$.$# .$.$####
#    #     # ### #     #  ##
# .$.$# .$.$# .$.$# .$.$####
# $.$.# $.$.# $.$.# $.$.$. #
# .$.$# .$.$# .$.$# .$.$. .#
##    ###   #     ###   ####
### # ###   # ### ### # ###
##    ###   #     ###    ##
# ####$###$####$###$#######
# ####  #. .  #  .$. .#   ##
# ########$########$#######
# ######## .  #### ##   ###
# ####   # $.$# .  #########
#   ##  @# $.$# .   ########
#######   $.$#   ##########
##########   ##############