 #########################
##    #  #  #  #  #    ###
# .#  #  #  #  #  #  #   #
#  .  $  $  .  .  .  $  .#
# .#  #  #  #  #  #  #   #
#   ########################
###    ###    ###    ## . #
##    #  #  #  #  #    #  .#
#  .  $  $  .  .  .  $  .  #
# .#  #  #  #  #  #  #   ##
#   ###   ###   ###   ###
###    ## . ###    ###   #
##    #  .#   #  #  #   ###
#  .  $  .  $  .  .  $  . #
# .#  #   #  #  #  #  #  #
#   ###    ###   ###   ###
###   ## . ###    ###   ##
##    #  .#   #  #  #    ##
#  .  $  .  $  .  .  $  . #
# .#  #   #  #  #  #  #  #
#   ###    ###   ###   ###
###   ###    ## . ###    #
####    ###    ###    #  #
#   #  #  #  #  #  #    ##
#.  $  $  .  .  .  $  .  #
#   #  #  #  #  #  #  # .#
###    ###    ###    ### 
#########################