   ####
   #  ####
  ##     #
   # ##  #
   # # . #
   ## # ##
 ####. . #
 # $...$##
 #  $.$ #
##... .##
# ## # ##
# # . # ####
#     @    #
#### # ####
   # # #
   #   #
   #####