   ############
   #          #
   #  ######  #
   #  #   ##  #
   #  # .$.#  #####
   ##$$.#$.#  #  ##
  ## $.-$.$## #  ##
  #  $.$@$.## #   #
  # ##$.-$. ##    #
  #  #.$.$.## #   #
##  # .$.#  # ## #
#  ##  ##   #$$  #
#   ##   # ##  ##
#####  # ##  ##
    #  #  ##
    #  #
    ####
    