   #####
   #   # ######
   #   ###   ##
#### # # ..   #
#    # #..  # #
#  ### ..  # ##
# ## $  #$$   #
#  ##### $ #$##
##     ##$  # #
 #  # @  $    #
 #    #########
 ######