#################################
###   ###   ###   ###   ###   ###
##     # #     # #     # #     ##
# .$   # #  $  # #  .  # #   $  #
#                               #
#.  $  # #  $  # #  $  # #  $  .#
#                               #
# $    # #     # #     # #    $ #
##     $       $       $     # ##
###.### #.###.### #.### #.###.###
# $    # $     $ #     $ #    $ #
#      # #     # #     # #      #
#.  $  # #  $  # #  $  # #  $  .#
#      # #     # #     # #      #
# $    # $     $ #     $ #    $ #
###.### #.###.### #.###.###.###.###
##     $       $       $     # ##
#    $ # #     # #     # #    $ #
#  .   # #  $  # #  $  # #   .  #
#                               #
#   $  # #  $  # #  .  # #  $   #
##     # #     # #     # #     ##
###   ###   ###   ###   ###   ###
#################################