 ####
##  ####
#  #   ##
#   $.. ##
# $$#.. # #
### #. #$ #
 #  # ##  #
 # $   $  #
 #   #@   #
 ####   ##
    #####