   #####
   #   #  ####
 ### # ####    ####
 #   # #  ######  #
 # $$$   $       .#
 #.$   $$.######  #
 #.$ #   ...#  #  #
 #.  #####. .  ## #
 #.$$$$  ....$$ # #
##.#  # #.#.#  # # #
# $    @.$      #  #
#  ###### .  ##   ##
#        ......####
##########. ####
         ###