 
           #####
      ######   #########
     ##               ## #####
    ##                 ###   ####
    #                   #       #
   ##            $ . . . $       #
  ##             #########
  #              ## ##  ####
 ##          ..###  #####
##      ########
#       ## ## ####
#       #### .  ##
#        $ . @   ##
#        $ .      ##
#        $ .       #
##      #### ### ..##
 ##          ##
  #          ##
  ##         #
  ###       ##
    #       #
    ####   ##
       #####