           ####
           #  ##
         ###$  ##
         #     $#
  #######  $   # ####
  ##   ## $ #$ # #  ##
### .$. ## # ##.$.$ ###
# $.$.$. #  # #$.$.$  #
# .$.$.$#$ ## # .$.$.$#
# $.$.$. #  #  $.$.$  #
### .$. ## # ##.$.$ ###
  ##   ## $ #$ #  ##
  #######  $   # ####
         #     $#
         ###$  ##
         #  ##
         ####