   ############
   #          #
   #  ######  #
   # #$ $ $ #$#
   #  ..#..  #
   ## # # # ##
#### $ $ $ $ ####
#   ## # ##    #
#  ##  $@$  ##  #
#### $ $ $ $ ####
   ## # # # ##
   #  ..#..  #
   # $#$ $ $# 
   #  ######  #
   #          #
   ############