#############################
####    ##    ##    ##    ###
### .$  ## .$ #  . #  .$  # ##
## ...  # ....#    # ....  . #
# ..  #### .. ###  ### .. ####
# ..    ##    ###  ###    ##  
# ..  #  @ .   ##  ##  .  #  #
# ..  #  $. #  ##  ##  .  #  #
# ..  # $.. #  ##  ##  .  #  #
# ..  ####### ##  ##  .  #  #
# ..    ###    #  #   ..  #  #
##      #####  #  #       ## #
### #          $  $         ###
### #  #  ## #$$$ $$$ # ##  ###
###    #  ## $ $$$ $$$ #  #  ##
### .    ## #$$$ $$$ # ##  . ###
### .##  ## # $$ $$ # ##    ###
### .##  ##   $   $     #  . ###
### .#   ## $$   $$ ##  #  . ###
### .#  ##  $ # # $  ##  #  . ###
### .#  ## $$   $$ ##  #  .  ###
### .#  ## $ . . $ ##  #  .  ###
### .#  ## $  .  $ ##  #  .  ###
### .#  ## #     # ##  #  .  ###
### .#  ## #  .  # ##  #  .  ###
### .#  ## #  .  # ##  #  .  ###
###    ###   . .   ###      ###
#################################