    ####
  ###  ###
 ##      ##
 #   ..   #
 #  .  .  #
## $    $ ##
# $ $..$ $ #
 ##$     $##
 ## $$$$ ##
  #  $@$  #
  #### ####
   ###  ##
   ##    #
   #  $$##
   #    #
   ######