###############################
#   #   #   #   #   #   #   #   #
# # # # # # # # # # # # # # # #
# $.$.$.$.$.$.$.$.$.$.$.$.$.$.$ #
# $.$.$.$.$.$.$.$.$.$.$.$.$.$.$ #
# $.$.$.$.$.$.$.$.$.$.$.$.$.$.$ #
# # # # # # # # # # # # # # # #
# $.$.$.$.$.$.$.$.$.$.$.$.$.$.$ #
# $.$.$.$.$.$.$.$.$.$.$.$.$.$.$ #
# $.$.$.$.$.$.$.$.$.$