 ######     ####     #####
##    #####    #   ###   ##
# $ $ ##  ####   ## ## $ $ #
#  $     $ # #########  $  #
#   ####  #   #######     #
#    ##   # # #######  ####
#      #  # ##      ######
##### #   #  ###### ##....#
##### #     ##  ##  # ....#
##    #######       ##...#
# $ $ $ ##  #.###### ##.##
#        $.....#  #    ##
#  ###### .....#     # #####
#### ## #  .....###### #####
 #      # ##.....##  #  $ $ #
     #  # ##.....## $ $   $ #
#####   # ##. # # ##   #####
## ###### #    .  #   ##
#     ##  # #  #.########
#     ##    ##########
#     ######
#   @ #
#####