 #########################
##   #   #   #   #   #   ##
# .  #   # . #   #   #  . #
#                         #
#   .  # .  #   # .  #   .##
### #### ### #### ### #####
##   #   #   #   #   #   ##
# .  #   # . #   #   #  . #
#                         #
#   .  # .  #   # .  #    #
## ### ### ## ### ###  #. #
#    #   #   #   #   #  . #
#  $ # $ # $ # $ # $ #    #
#                         #
#    #   #   #   #   #   ##
# .  #   # . #   #   #  . #
##.  ### .## ### .##  . ###
### #### ### #### ### #####
##   #   #   #   #   #   ##
# .  #   # . #   #   #  . #
#                         #
#   .  # .  #   # .  #   . #
### #### ### #### ### #####
##   #   #   #   #   #   ##
# .  #   # . #   #   #  . #
#                         #
#  @   # .  #   # .  #     #
## ### ### ## ### ### ##. #
# .  #   #   #   #   #  . #
##.  ### .## ### .##  .  ##
### #### ### #### ### #####
##   #   #   #   #   #   ##
# .  #   # . #   #   #  . #
#                         ##
#   .  # .  #   # .  #   # #
###########################