   ####
   #  #
  ##  #
  #   ###
  # $ $ #
###. .# ####
#       #  ##
# .$ $. #   #
##### # #$. #####
    # # .  #   #
  ### ###$  #  #
  # . $  $ ## #
 ##. #### #  #
 #       # ###
 #  ###  # #
 #### #### #
   ## $ ##
  ##.$ $.#
  #  #  #
 ## ###  #
 #  $  $ #
 #. .# ###
## ###  #
#  $  #  #
# # ####
#   ##  #
### #  ##
  #   # #
  #  ##  #
  ####