  ####
###  ####
#   $   #
# #..#  #   ####
#  ..   # ###  ####
##      # #  $    #
## # ## # # $$$ # #
#  # ##  #   $ # #
# @      ##  #   #
### #### #..  ## #
  #      #..  #  #
  ######## .. ## #
         #  $    #
         ####  ##
            ####