 #######
##  #  ##   #######
#     #.#   #     ##
#  .....#   #  $ $ #
## ..-..### #     #.#
## .. .  ## #   # #.#
#  .....       # #.###
#   ###   ## ## # #..#
## # # #  ## ## #   ..
## # # ## ## ## # ...#
#  # # ## ## ##   ...#
#  #   #  ## ## # ...#
#      #    #  #   ..#
#  $ $  #   #       ##
##     #   #.#######.#
 #######   ###     ##
       #####  #@   #
       # ##   ..   #
       ###  ....   #
         #  .  ..  #
         #### ####