  #######
 ##     ##
 #   #   #
 # .$. . #
## $-$-$ ##
#  $-$-$  #
# .$.$.   #
#   # ## ###
###### #   #
     #   $ #
  #### .$. #
  #  $ @  ##
  # $$$   #
  #. .####  
  # $ $ $#
 ##-$---$##
 # $-$-$ #
##-$-$-  #
# $.$.$. #
#   #   #
######  #
     #  #
  ####  #
  #  ####
  # ##   ###
  #   #   #
  #####   #
      #   #
  ### ##  #
 ##  $ #  #
 #   $$#  #
 #  @  .$.#
 ### ######
   #      #
   ########