  #####
  #   #####
### $$$   #
#   ## .  #
# .@#..   #
# $$# #  ###
##  $  $ ##
 # # #.# #
 #  $ $  ##
 ## #  $ ##
  #   #$ ###
  ##    .# #
  ###  ##   #
    #####