  ####
  #  #####
  #     # ###
  #   +$.# # ####
 ##  #$.# #     ###
 #  ##.# #   .$@$.  ####
##   .  # #. $  #  ##  ###
#  $.$. # #. +  #  #   # ####
# # .   # #    #  # $ # #  ###
#  .#### #  ####  ##.## #    #
# $ #    #  #  # $$ $. #    ##
###  # $ #  #    .  .  # .  #
  ####   ###### #### ##  ###
     #####    #    # ####
           # #      #
           #  #######