###############
#  #  #  #  #  #
# $#$ $#$ $#$ #
### #  #  # ###
#  $   $ $   $  #
#.# ..# ..# .#..#
#  $   $ $   $  #
### #  #  #  ####
# $#$ $#$ $#$   #
#  #  #  #  # @ #
###  #  #  #  ###
  #  $   $   $  #
  #..#. ..# ..#.#
  #  $   $   $  #
####  #  #  #  ###
   $#$ $#$ $#$  #
  #  #  #  #  #  #
### $#$ $#$ $#$ ###
#  #  #  #  #  #  #
#$ $ $ $   $ $ $ #
# ###  #  #  # ### 
#  $ $.$.$.$ $ $  #
## ### #  # ### ##
#  $ $.$.$.$ $ $  #
# ###  #  #  #  ###
#  #  #  #  #  #  #
### $#$ $#$ $#$ ###
#  #  #  #  #  #  #
# $#$ $#$ $#$ $#$ #
###           ###