 
           #############################
           #    #    #   # #   #    #  #
           # #### ## ### # ### ## #  #
           # #  # ##  #    #  ##  #    #
           # #     ## ## # ##  #  #####
           # ## ###   #    #     #    #
           #    #  # ### ## ### ## #  #
           #### #  #  #    #  ##  #  ##
           ##  ### #  ### #  ### #    #
           #    #  # ##   ##   #  #####
           #  # #  #    ## ##     #  #
           # ## #### ##  #    # # ## #
           #  # ##  #    #  # #    # #
           #    #    # ## #### ## #  #
           # #    # ##  #  ##  #    # #
           # ## #  #  # ## #  #  #  ##
           #  ##  ### #  ### # ### ##
           #    #  #    #  #    #    #
           #### #    #### #    #  ##
           #    # #     #  #### #  ##
           #  #    ## ###    #    #  #
           # ## #  #    #  #  #  #  ##
           #  # #### ##  #  #### ##  #
           #    #    #  #### ##  #  ##
           #############################