  #### ########## ####  
 ##  #   ##   #  #  ## 
 #      #  $      #  #
 # .  .   -#   .  $ - #
 # #####@$# #####  . #
 # .  .   -#   .  $ - #
 #      #  $      #  #
 ##  #   ##   #  #  ##
  #### ########## ####