  ############
  #          #
  #  $    $  #
  #### ######
 ###  #  #  ####
##   # $    $  #
#   ##        ####
# .. #.###  #  # #####
##### ###.# $# $# #  #
 # $    $#$.$   $#  #
 #   ##  # $# # #   #
 #### # #   # $  $  #
    #  $  $ #     ##
    ##      #..  ###
     ####  # ..  #
        #  ######
        #
        #
        #
        ##
        #
        #
        ########
        #      #
    #####      ####
    #   .  .@#  $  #
    #   $$$. #######
    #### . .#  #
     ##     $ ##
     #  ####   #
     ##  #  ####
      ######