  #########
  #       #####
  # ##### .  ##   ########
  # #   #  .  #####      #
  # # $   . #       #### #
  # ## ###$##########  # #
  #  # ## $          $ # #
  ## #  # # #####  ##  # #
   # #  #   ##  ##### ## #
   # # ###$######   #    #
   # # # #.#   .$ #$$. .##
 ### # # # .$ .##   # . #
 ##  # ###  ##$ ### ##  #
 #  ## ### $##  ### #  ##
 # . #   ##. $. # # # ###
##. .$$# $.   #.# # # #
#    #   ######$### # #
# ## #####  ##   #  # #
# #  ##  ##### # #  # ##
# # $          $ ## #  #
# #  ##########$### ## #
# ####   @   # .   $ # #
#      #####  .  #   # #
########   ##  . ##### #
           #####       #
               #########