   #######
 ###     ##
 #   ###  #
 #      # #
###$#@  # #
#   ##### #
#   #   . #
##$$#   .##
 #      ..#
 #### #...##
    # #$$$ #
    #   $  #
    #####  #
        ####