       #####
       #  ##
      ##$  ##
  ##### .$. #
### . . $.$.#
## .$.$.$$. #
#  $.$    $.##
# $.$$ ## .  ###
###  . ## $$.$ #
  ##.$    $.$  #
   # .$$.$.$. ##
   #.$.$@. . ###
   # .$. #####
   ##  $##
    ##  #
    #####