   ##########
  ##        #
 ##    ###  #######
 # $$ #    $#  #  #
 #  ###  #$$      #
 #    $$ #     #$$#
 #  #   #### #$   #
 ## # ###. . # ## #
##  . .#.. .##    ###
#     ...  .### $$  #
# #....#...#  #   # #
#  ## ##. . $ # ### #
##  # $ ..##   $  # #
 ## # $$### $#$$  # #
  #  @  #   $    #  #
  #####   ##$####  ##
      ######      ##
           ########