        ######
        #  ###
        #    #
        # $$ #
        ##.###
        ## #
##### ### .###
##  # #  .$. ########
## $### .$ $.  ##   #
#  $. .  $@$  . .$  #
#   ##  .$ $. ###$ ##
######## .$.  # #  ##
       ###. ### #####
         # ##
       ###.##
       # $$ #
       #    #
       ###  #
       ######