                #####
          #######   # #####
     ######       #.###   #
    ##      # ### #.      #
    #  ###### ##  #  ### ##
    # ## $ ..$ # $   ##  #
    # #  $  .$@##### #  ##
    # #    ..$ # $   # ##
#####$#######$## # .   #
# $            . #### ####
# $$# #########$##   .   #
# # . .#      .  # $$ $$ #
#   .  # $.$.#   #... ...#
##### $ # ## ##### $$ $$ #
    #.#    #         .   #
    ######################