######    #######
#  ..#    #  #  #
#  ..###### $#  #
## #.  $ ##  $  #
 #  $$$   # ##$##
 #.#. #$ $  #  #
 #.#.## ##  $  #
 #.#   $  # #  #
 #. ##   @# ##$#
 #.   ####     #
 #.      $  $# #
 #. ########   #
 ####      #####