   ########
  ###     #
#### $  .$##
# $ $.# . ###
# ..# # #$ ##
#        .$ #
#  ## # ##  #
# $.        #
## $# # #.. #
### . #.$ $ #
 ##$.  $ ####
  #  @  ###
  ########