# ############# #
  #  #     #  #
###  #  #  #  ###
#  $  .$ $.  $  #
#    .$.$.$.    #
### .$.$.$.$. ###
#  .$.$.$.$.$.  #
#  $.$.$.$.$.$  #
# # $.$.@.$.$ # #
#  $.$.$.$.$.$  #
#  .$.$.$.$.$.  #
### .$.$.$.$. ###
#    .$.$.$.    #
#  $  .$ $.  $  #
###  #  #  #  ###
  #  #     #  #
# ############# #