   #####
   ##  #  ####
 ###   ####  #
 #  . $ ##   ###
 #   .$ #   . ##
 ##   # #  .   #
  ##  # ###$$  #
  #####@     ###
###      #####
#  $$### #  ##
#   .  # #   ##
## .   # $.   #
###   ## $ .  #
  #  ####   ###
  ####  #  ##
        #####