##### ########
#   ### . $  #
#   $  .. #$ ##
## $# ..  $  @#
 #  $ . ###   #
 ######## #####