         #####
##########   #
#      $ $$$ #
# $## #  # # #
# $    # # # #
##$## .#.    #
 #   ..... # #
 #$ ##.@.## $#
 # # .....   #
 #    .#. ##$##
 # # # #    $ #
 # # #  # ##$ #
 # $$$ $      #
 #   ##########
 #####