    #####
    #  ##
    # $##
    #  ##
#####  ######
#####. .    #
# $   @   $ #
#    . .#####
######  #####
    ##  #
    ##$ #
    ##  #
    #####