   #######
  ##     ##
  #  ###  #
  # ## $  ####
  # # .#   $.####
  # #    ###.$  #
  # #  #   ### #####
  # # @      # #   #
  # #  ### # #     #
  # ## #     .# # #######
  # #  #     ....$  $   #
  # # ## $# $####$      #
###          #    #######
#   ########## ####
#              #
##  ############
 ####