  ####
  #  #
  #$ #
###  ###
#   $$ #
#  ... ###
## $  $$ #
###$.... ###
  # .$  $$ #
  ###$.... #####
    # .$  $$ $ #
    ###$....  @#
      # .$.$#  #
      ###$. ####
        #  $#
        #   #
        #####