       ######
       ##  ##
       ##  ##
      ### .###
     ##.$.$  ##
    ##.$.$    ###
   ##.$.$    $ ##
  ##.$.$    $.$.#
###.$.$    $.$.##
##.$.$    $.$.###
#.$.$    $.$.##
## $    $.$.##
###    $.$.##
  ##@ $.$.##
   ###. ###
    ##  ##
    ##  ##
    ######