            #####
        #####   #####
    #####   # $ #   #####
#####   # $$     $$ #   #####
#   #$$ .   ##$##   . $$#   #
# $$.   ##### . #####   .$$ #
#   #####   ##.##   #####   #
##$ #   #.... . ....#   # $##
 #  . $ .   # @ #   . $ .  #
##$ #   #.... . ....#   # $##
#   #####   ##.##   #####   #
# $$.   ##### . #####   .$$ #
#   #$$ .   ##$##   . $$#   #
#####   # $$     $$ #   #####
    #####   # $ #   #####
        #####   #####
            #####