             #####
##############   #
#. ............ .##
#  ########    #  ##
## $ ##  # #    #  ##
 # $  #  ## #    #  ##
 # $  #   ## #    #  ##
 # $ ##    ## #    #  ##
 # $  ##    ## #    #  ##
 # $  ###    ## #    #  ##
 # $ $ ###    ## #    #  #
 # $  $  ##    ## #    @ #
 # $ $$  ##     ##       #
 # $## ###       #########
 #  #  ##
 #    ##
 ######