  #####################
 ##        #     #    #
 #  $ $ $  #$ $ $ $  $###
 # $##### $$  $## ## $  #
 #  #  ..#   # #    #   #
 ##$   ... # #   ...#$ ##
##   $ ... #$ #  ...$  ##
#  $####..#    ##...##$ #
#     . ..$$@$$.. .     #
# $##...##    #..####$  #
##  $...  # $# ... $   ##
## $#...   # # ...   $##
#   #    # #   #..  #  #
#  $ ## ##$  $$ #####$ #
###$  $ $ $ $#  $ $ $  #
  #    #     #        ##
  #####################