################
#              #
# .$.$.$.$.$.$ #
# $.$.$.$.$.$. #
# .$.$.$.$.$.$ #
# $.$# ## #.$. #
# .$. #  # $.$ #
# $.$# ## #.$. #
# .$.# ## #$.$ #
# $.$ #  # .$. #
# .$.# ## #$.$ #
# $.$.$.$.$.$. #
# .$.$.$.$.$.$ #
# $.$.$.$.$.$. #
#@             #
################