 #######
 ##  ###
 # . ###
##     #
# @  $ #
#    ###
#  #####
####