       #######
####   #     #
#  ##### # # #
#     . . . .#
#  #  .#.#.#.#
##  # ## # # #
### #    # # #
#   #   ## # #
#   ###    # #
## $$ #   ##$#
 #    ###    #
 ##  $$ #   ##
  ##    ###@#
 # ##  $$   #
  # ##    $ #
   # #  #####
     ####