        #####
        #   #
       ## $ ##
     ### $.$ ###
     #  $. .$  #
   ### $  .  $ ###
   #  $  . .  $  #
  ## $  .   .  $ ##
### $  . .$. .  $ ###
#  $. . .$ $. . .$  #
# $. .  $   $  . .$ #
#  $. . .$ $. . .$  #
### $  . .$. .  $ ###
  ## $  .   .  $ ##
   #  $  . .  $  #
   ### $  .  $ ###
     #  $. .$  #
     ### $.$ ###
       ## $ ##
        # @ #
        #####