####################
#   . $  ..   $.   #
#  .   $ ..  $.$.  #
# .     $ $ $.$.$. #
#.        .$.$.$.$.#
#        . .$.$.$.$#
#$       $ $.$.$.$ #
# $   $.$.$   $.$  #
#  $.$   $.$.$   $ #
# $.$.$.$ $       $#
#$.$.$.$. .        #
#.$.$.$.$.        .#
# .$.$.$ $ $     . #
#  .$.$  .. $   .  #
#   .$   ..  $ .  @#
####################