   #### ####
  ##  # #  #  #######
###   ###$ ## #     ###
#  $      $ ###       #
# $ $ ###$   #  #     #
### ### #    #   #    #
#  $ #  ## ###    # ###
#    $   # #@        ##
# $# # ### ###   #   #
#  $ # # $ $ #  #  # #
##   #    $  # #.    #
 ##  # #   ## #..  ###
  ## # #  ## #... ##
 ### # #### #....##
 #          $. .##
 ############..##
            ####