#######
#  .  ##
# @ $$ ###
###$...  ##
###. $ $$ #
######$.. #
# ####. $ #
###########