#######
##  ###
##   ##
# .$$##
#     #
#..#$ #
#   @##
#######