################
#  .   . .$    #
#@ $.$.    . . #
## $ $  $ $ # ###
 ##### #### #  #
     #   ## ## ##
     ### #   $. #
      #  #      #
     ## ## ######
     #   $. #
     #      #
     ########