              ####
###############  #
###    $ $ $     #
##    #  @   # # #
# $# ####.#### #$#
#   $ #.....# $  #
##$#  #. . .#  #$#
 #  $  . # .  $  #
 #$#  #. . .#  #$##
 #  $ #.....# $   #
 #$# ####.#### #$ #
 # # #      #    ##
 #     $ $ $    ###
 #  ###############
 ####