            #########
            ####  ###
      #######  $ . ##
      ####  $ .     #
#######  $ .   . $  #
####  $ .   . $  ####
# @$ .   . $  #######
#     . $  ####
## . $  #######
###  ####
#########