#  ###
 ##   ##
 # .$  #
# .$.$ .##
# $.$.$  #
#  $.@.$  #
 #  $.$.$ #
 ##. $.$. #
   #  $. #
   ##   ##
     ###  #