     #######
     #  ####
  ####  ####
  #   . . ##
  #   #    #
  #   ## $ #
  # .#@ # ##
  #   $ $ #
  # .#$   #
  #    ####
  #  ######
  #########