      #####
 ######   #
 #  $ $ # #
 # ..+..# #
###.###.  # ####
#  $### .####  ##
# $  $  $      ###
##   ###.$  # $  #
 ##### #  ###  $ #
       #### #  # #
            ##   #
             #####