       ###
     ##   ##
   ##   $   ##
  #  $.# #.$  #
  # #.$ . $.# #
 # $.  # #  .$ #
 # .$ $. .$ $. #
#  # #.$ $.# #  #
# $ .   @   . $ #
#  # #.$ $.# #  #
 # .$ $. .$ $. #
 # $.  # #  .$ #
  # #.$ . $.# #
  #  $.# #.$  #
   ##   $   ##
     ##   ##
       ###