####
#  #####
#  . ###
#    ###
##     #
 #  $@ #
 #  ####
 #######