###### ######
#    ####   #
#  #   #    #
#  $.   .$# #
## .$ . $.  #
### #$ $# ###
#  .$ . $. ##
# #$.   .$  #
#    #   #  #
#   ####   @#
###### ######