    #######
    #     ###
    # ###$  ##
    #....$   #
  ### ## #   #
###@.$  # # ##
# . .$   ## #
#  $.$  #.$$#
#  ## ##    #
#####   # ###
    ###  $ #
      ##   #
       #####