    ####
#####  #
#      #
#$ $ $ #
#. . . #
# . . .#
# $ $ $#
#......#
#. . . #
#$ $ $ #
# $ $ $#
#$ $ $ #
#      #
#@ #####
####