 ##########
 #    #   #
 # $  #   #     ####  #####
 ### $$   #######  ####   #
## $  $  ###   ##  $      #
# $   ###  # # ##  ##### ###
#  #$#       ..### ##  #   #
#    #  #.# #.. #   # $  $ #
### $ $ #.# #.. #   #  ## ##
  #  #  #.#  #### #### ##  #
 ########.#         # $  $ #
 #  ..  #.# ######  #   #  #
 #.$$$$.#.# #   #  #### ####
 #.$ @$.#.# # # #  $      #
 #.$$$$.#.# #   #  ####   #
 #  ..   .  #   ####  #####
 ############