  ######
  ##   ###########
  # $ $  $  #    ######
  # . .#.. .# .$     ##
  #    # $ $    $# .$ #
 ## ####    # .  #    #
 #  $ #########.## .$ #
 #. ..          #### ##
 #$ $ #$#.$$. # #    #
 #    # # .$$.#$# $ $#
## ####          .. .#
# $. ##.######### $  #
#    #  . #    #### ##
# $. #$    $ $ # .$ #
##     $. #. ..#   @#
######    #  $   .$ #
     ###########   ##
               ######