  #####
  #  ####
###  $ ####
#    . $ ##
#   # .   ##
##$. # # $##
##  . @ .  ##
 ##$ # # .$##
 ##   . #   #
  ## $ .    #
  #### $  ###
    ####  #
      #####