        #####
     #### . ####
     # ##$.$## #
   ####   .   ####
   # ## $$.$$ ## #
 ####  ## . ##  ####
 # ## # #$.$# # ## #
 ##  # #  .  # #  ##
### $## #$.$# ##$ ###
# $ $ $ $...$ $ $ $ #
#.........@.........#
# $ $ $ $...$ $ $ $ #
### $## #$.$# ##$ ###
 ##  # #  .  # #  ##
 # ## # #$.$# # ## #
 ####  ## . ##  ####
   # ## $$.$$ ## #
   ####   .   ####
     # ##$.$## #
     #### . ####
        #####