 ###########
##    #    ##
# $$ .$. $$ #
#...     ...#
# $$ .$. $$ #
##         ##
# $$ .$. $$ #
#...  @  ...#
# $$ .$. $$ #
##    #    ##
 ###########