         #######
  ########  #. #
  #        $   #####
  # ## ##   #. #   #      ####
### # $ $$#$#. # # ########  #
#  $#   #  $   #......       #
# $    ### $#.  #  ####      #
## # #$$ # $ .# #  #  ##     #
 # #   $   @##  # ##   ##   ##
 #  ##  $$$ #  ## ###   #####
 ##  #.##.###       #
  ## # $. ...  ##   #
   #   #   ##  ##  ##
   ###   ###########
     #####