 ####
 #@ #####
 #  $ $ #
## # .. ##
#  .   ###
# $$..$$ #
###   .  #
###$..$###
#  .   ###
# $$..$$ #
###   .  #
## .. # ##
 # $ $  #
 #####  #
     ####