#####
##  #
## $##
#  @ #
# .  #####
###   $  #
  #  .   #
  ### #  #
    #   ##
    ######