    #####
    #  ##
    # .##
    #$ ##
#####  ######
#####$.$ $  #
# .  .@.  . #
#  $ $.$#####
######  #####
    ## $#
    ##. #
    ##  #
    #####