    ####
    #  ####
    # $   #########
    # .#    $ ##  #
    # $# .## $    ##
 #### .###   #$$   #
##  ## #  .. # $$  #
#  $      ...#   $ #
# $  #####... #   ##
#  $#   #  .  @####
###   # #    # #
  #####  ####  # #
      ##      ##
       ########