########
###    #
###$##@#
# . .. #
#  $$ ####
### #    #
  #    # #
  ## #   #
  ##   ###
  ########