          #
         # #
        #   #
       # $.  #
      #       #
     #         #
    #           #
   #             #
  #               #
 #               $ #
#  .      @      .  #
 # $               #
  #               #
   #             #
    #           #
     #         #
      #       #
       #  .$ #
        #   #
         # #
          #