    ####
    #  #
    #  #
    #  #
    # ##############
    #$$ $ $ $ $    #
    # . .   ..$#   #
    #$.  . .   #####
    #  .     .$#
    #$      .  #
    #  .      $#
#####$.     .  #
#   #   . .  .$#
# @  $..   . . #
##   $ $ $ $ $$#
############## #
            #  #
            #  #
            #  #
            ####