#############################
#.      .   .   .   .      .#
# ##  # # # # # # # # #  ## #
# ##  $ # $ # $ # $ # $  ## #
#  ##$$$#$$$#$$$#$$$#$$$##  #
#   $...$...$...$...$...$   #
# #$$.#.$.#.$.#.$.#.$.#.$$# #
#   $...$...$...$...$...$   #
#.###$$$#$$$#$@$#$$$#$$$###.#
#   $...$...$...$...$...$   #
# #$$.#.$.#.$.#.$.#.$.#.$$# #
#   $...$...$...$...$...$   #
#  ##$$$#$$$#$$$#$$$#$$$##  #
# ##  $ # $ # $ # $ # $  ## #
# ##  # # # # # # # # #  ## #
#.      .   .   .   .      .#
#############################