  ####      ########
  #  ##### ##   #  #
  #    $ ### $  $  #
  #  $ # ##    $   ####
  ###  #    # ###$##  #
#####  ###  ####   $  #
#   # $  $$## .. ##$  #
#  $$   # $          ##
##  # $##  #### # ####
### #  ##$ ###..#..#
#   ###..  #  .....###
#   #   .### #  #..  #
##$$#   .##@ #  #    #
 #      . ####  ###  #
 ######   #  #       #
      #####  ##    ###
              #  ###
              ####