#########
#       #    ######
#   $   ######    ###
# #$#$ $ $  # $     #
# $   $@$  $ $ $ $$ #
# $ $# $ #     $$$  #
#  $ $ #######   #####
##    ###....##### ..#
 ###$$# $$$$ #...  ..#
  #         ##   #.. #
  #  #  #$###....## ##
  #   ##..$. ....    #
  ### .    .#....#   #
    ##################