 #######
##     # #
#   .$.#
#   .#.###
# #$@$$  #
#   ## # #
######   #
     #####