#############
#@  #   #   #
# # # # # # #
#   #   $   #
# #####. .###
#   #   $.  #
# #$# # #$# #
#  .$       #
###. .##### #
#   $   #   #
# # # # # # #
#       #   #
#############