   #####
   #   #
 ###   ########
##         # # #
 #         ## # #####
##        ## # ##   ##
 ###   #### # # #   #
   #   # # # ####$ $###
  ##   ## # ##  $...$ ##
   ##### # ##    .@.  #
        # # #   $...$ ##
         ########$ $###
                #   #
                #####