####  #####
#  ####   #
#     # $ #
## $.$    #
 # . .# ###
 # $.@.$ #
### #. . #
#    $.$ ##
# $ #     #
#   ####  #
#####  ####