 #######
 #     #
 #  @  #
 ##$#.##
 #  #  #
 # $#. #
 #  #  #
 # $#.##
 #  # #
## ## ##
#      #
#      #
###   ##
  #####