          #
         # #
        # # #
       # # # #
      # #   # #
     # #     # #
    # # .$.$. # #
   # # .$ # $. # #
  # # .$ # # $. # #
 # #  $ # # # $  # #
# #   .# # # #.   # #
 # #  $ # # # $  # #
  # # .$ # # $. # #
   # # .$ # $. # #
    # # .$.$. # #
     # #     # #
      # #   # #
       # #@# #
        # # #
         # #
          #