######
##  ##
## $######
#  @ #  ##
# .  #$.##
###   $. #
  #      #
  ########