#############################
##  #################  ######
##  $ $ ####  #  #     $ $ ##
## # .. ##   $ $   ## # .. ##
#  .   ### # .$. # #  .   ###
# $$..$$ # #$...$# # $$..$$ #
###   .  # # .$. # ###   .  #
## .. # ##    $    ## .. # ##
## $ $     #  #  ###  $ $  ##
######  ############ ####  ##
####################  #######
###   ##    ##  ##### #######
### # #  ##  #  #####  #  ###
### $.   ##$.#$.###   $ $   #
### .$   # $.$ .  # # .$. # #
#### #$. #  .#$.$ # #$...$# #
##  .$.$ ##$.  .$## # .$. # #
## #$.$. ## $ .  ##    $    #
##    #  ###   ###  #  #  ###
#######   ##       ##########
######### ###################
#######   ############   ####
####  #  #######    ##   ####
#### $$$ ##   #  ##  $$$$$ ##
####.....##  $ $ ##   . .  ##
##  #$.$##   .$. #####.#.####
##   $. ## ##.  ###### ..  ##
## $  .    # . .  ####.#.# ##
#####$.$  ## $ $  ##  . .   #
#####  ####   #   ## $$$$$  #
########### ##########   ####
########@   ##########   ####
#############################