 ####### ####
 #  #  ###  ###
##.$#  . # .. #
# .$   $ # $$ #
#   ## #### ###
###### . ##   #
 #  #  $      #
##.$#.$@$.#$.##
#      $  #  #
#   ## . ######
### #### ##   #
# $$ # $   $. #
# .. # .  #$.##
###  ###  #  #
  #### #######