   #######
 ####  #####
 #  #  $ $ #
##$.#$ . . ##
##  # .######
##$.#    $  #
#   . @ .   #
#  $    #.$##
######. #  ##
## . . $#.$##
 # $ $  #  #
 #####  ####
   #######