#####                 #####
#   ###################   #
# # $ $ $ $ $ $ $ $ $ $ # #
# $ #     #     #     # $ #
##  #.###.#.###.#.###.#  ##
 #$ #  .  #     #  .  # $#
 #  .  #  .  #  .  #  .  #
 #$###.#.###.@.###.#.###$#
 #  .  #  .  #  .  #  .  #
 #$ #  .  #     #  .  # $#
##  #.###.#.###.#.###.#  ##
# $ #     #     #     # $ #
# # $ $ $ $ $ $ $ $ $ $ # #
#   ###################   #
#####                 #####